all: zǝmʕwa | зымгIва 
ashes: qwa | хъва 
bark: čwa | чва 
belly: mgwa | мгва 
big: du | ду 
bird: pssʕaḉwǝ | пссгIачIвы 
bite: c-ħa-ra | цхIара 
black: kwajḉwa | квайчIва 
blood: šˊa | ща 
bone: bʕwǝ | бгIвы 
breast: ḳǝḳa | гвтшпы 
burn tr.: bǝl-ra | былра 
claw (nail: napχǝ 
cloud: pstħwa | пстхIва 
cold: χˊšvašva | хьшвашва 
come: ʕa-jra | гIайра 
die: ps-ra | псра 
dog: la | ла 
drink: žw-ra | жвра 
dry: jǝrʕwu | бах 
ear: lǝmħa | лымхIа 
earth: adgˊǝl | адгьыл 
eat: fa-ra | фара	чара 
egg: ḳwṭa-ʁˊ | кIвтIагъь 
eye: la | ла 
far: qara | хъара 
fat n.: šša | шша 
feather: qwǝ | хъвы 
fire: mca | мца 
fish: pslačwa | пслачва 
fly v.: pssʕa-ra | пссгIара 
foot: šˊaṗǝ | щапIы 
full: aznata | азна 
give: at-ra | атра 
good: jbziju | бзи 
green: jaḉwa | йачIва 
hair: qwǝ-c | хъабра 
hand: naṗǝ | напIы 
head: qa | хъа 
hear: aʕa-ra | агIара 
heart: gwǝ | гвы 
heavy: χˊanta | хьанта 
horn: ḉwʕwa | чIвгIва 
I: sa-ra | са	сара 
kill: šˊ-ra | щ-ра 
knee: šˊa-mqa | щамхъа 
know: dǝr-ra | дырра 
leaf: bʁˊǝ | бгъьы 
lie: šˊṭa-za-ra | щтIазара 
liver: ḉʷa | чIва 
long: awǝ | ауы 
louse: ċa | цIа 
man: qaċa | гIвычIвгIвыс 
many: šˊarda | щарда 
meat: žˊǝ | жьы 
moon: mzǝ | мзы 
mountain: šˊqa | хва 
mountain: χwa | хва 
mouth: ḉa | шIа 
name: χˊǝz | хьзы 
near: argʷanǝ | аргваны 
neck: qwda | хъвда 
new: ḉǝ-c | шIыц 
night: ċχǝ | уахъы 
night: waqǝ | уахъы 
nose: pǝnċa | пынцIа 
not: -m- | =м- 
one: za-ḳǝ | за- 
person: ʕwǝḉwʕwǝs | гIвычIвгIвыс 
rain: kwa | ква 
red: ʠˊapšˊǝ | къапщы 
road: mʕwa | мгIва 
root: šˊata | щата 
round: gˊažˊǝ | гьажьы	гяжьы 
salt: ǯˊḳa | джькIа	джьыкIа 
sand: pχačaqwa | пхатшахъва 
say: ħwa-ra | хIвара 
see: ba-ra | бара 
seed: žʷla | жвла 
short: ajšǝs | айшыс 
sit: ḉwa-ra | чIвазлара 
skin: čwa | чважь 
sleep: čwa-ra | чвара 
small: ḉˊḳwǝn | чIкIвын 
smoke: lʕwa | лгIва 
snake: ašˊtanḉʷǝ | ащтанчIвы 
stand: gǝla-za-ra | гылазара 
star: ajaḉwa | йачIва 
stone: ħaqwǝ | хIахъвы 
sun: mara | мара 
swim: ӡca-ra | дзцара 
tail: ċǝqwa | цIыхъва 
that: ani | ани	ауи 
that: -ni | ани	ауи 
thin: ċa | цIа 
this: ari | ари 
this: -r-i | ари 
thou: wa-ra | уа	уара 
tongue: bzǝ | бзы 
tooth: pǝ-c | пыц 
tree: ċla | цIла 
two: ʕw-ba | гIвба 
walk (go): ca-ra 
warm: jpχu | пха 
water: ӡǝ | дзы 
we: ħa-ra | хIа	хIара 
what: aḉwǝja | ачIвыйа 
white: š-ḳwaḳwa | шкIвакIва 
who: dzaḉwǝj-a | дзачIвыя 
wind: pša | пша 
woman: pħwǝs | пхIвыс 
worm: χʷa | хва 
year: skʷšǝ | сквшы 
yellow: ʕwažˊ | гIважь 
every: зымгIва 
ash: хъва 
abdomen: мгва 
bigness: ду 
large: ду 
breasts: гвтшпы 
burn: былра 
claw: напIхы 
nail: напIхы 
talon: напIхы 
come from: гIайра 
be dead: псра 
dead: псра 
ground: адгьыл 
land: адгьыл 
soil: адгьыл 
fat: шша 
grease: шша 
lubricant: шша 
oil: шша 
fly: пссгIара 
left hand: напIы 
right: напIы 
1 sg.: са	сара 
be knowledgeable: дырра 
lie down: щтIазара 
head louse: цIа 
male: хъацIа 
much: щарда 
multiple: щарда 
several: щарда 
flesh: жьы 
hill: хва 
title: хьзы 
nighttime: уахъы 
adulterous: за- 
single: за- 
the: за- 
unprincipled: за- 
human: гIвычIвгIвыс 
human being: гIвычIвгIвыс 
rainy weather: ква 
path: мгIва 
route: мгIва 
hide: чважь 
little: чIкIвын 
smallness: чIкIвын 
rock: хIахъвы 
2 sg: уа	уара 
you: уа	уара 
grind: гIвба 
go: цара 
walk: цара 
hot: пха 
1 pl. inc.: хIа	хIара 
we₁: хIа	хIара 
whiteness: шкIвакIва 
who?: дзачIвыя 
female: пхIвыс 
distant: хъара 
dull: хьанта 
serious: хьанта 
close: аргваны 
ner: аргваны 
earthworm: хва 
