all: bɛd 
ashes: bur 
bark: apoga 
belly: ɛtʲ 
big: duwɔŋ 
bird: wɛnyɛ 
bite: kʰɛč | kʰɛč 
black: čol | čol 
blood: rɛmɔʔ | rEmo7	rɛmɔʔ 
bone: čoʷ | Co	Cou	čoᵘ 
breast: θʊṇo | 8u4o	θʊṇo 
burn: waŋ 
claw: lwɛːdo 
cloud: pʰolo 
cold: kʰɔʔ 
come: hɔy | hoy	hɔy 
die: θɔː | 8o	θɔː 
dog: gʷɔkʰ | gw~ukh~	gʷɔkʰ 
drink: matθ | mat8~	matθ 
dry: ho\tal | hoʼtal 
ear: yitθ | yit8~	yitθ 
eat: čɛm | čɛm 
egg: tɔnɔ 
eye: wɛŋ | wEN	wɛŋ 
father: wuːh 
fat (n.): maʷ 
fire: mač | maC	mač 
fish: rreɔʔ | reo7	rreɔʔ 
fly (n.): lʷaŋɔʔ 
foot: tiʲalɔ 
give: tɪpi 
good: bɛr 
grass: luːm 
hair: ǯiːr | ǯiːr 
hand: činɔʔ | Cino7	činɔʔ 
head: wɪč | wɪč 
heart: čwɪɲ | čwɪɲ 
hear: wɪɲiː | wini	wɪɲiː 
horn: tʊŋ | tuN	tʊŋ 
I: anɪh | anih	anɪh 
kill: nɛgi 
knee: čʊnŋ | CunN	čʊnŋ 
know: ŋeč | ŋeč 
leaf: bɔːgɔ | bogo	bɔːgɔ 
liver: čwɪɲ | Cw~in	čwɪɲ 
long: bɛ̰r 
louse: ɲuːwɔ | nuwo 
many: θoːθ 
man: θaːno | 8ano 
meat: rrɪŋɔʔ 
moon: dʷaːy | dᵘwaːy 
mountain: kɪdi | kidi	kɪdi 
mouth: ðɔːkʷ | ðɔːkᵘ 
name: nyɪŋ | 5iN	nyɪŋ 
neck: ŋudi 
new: nyan | 5an	nyan 
night: wɛr | wEr	wɛr 
one: ačʲel | aCy~el	aciɛl	ačʲel 
other: mɔro 
rain: kʰɔtθ 
red: kʷaː 
road: ǯoː | jo 
root: lwɛt˗ | lwɛt- 
sand: ha\kwuo | haʼkwuo 
say: čaːni | čaːni 
seed: kʰɔði 
see: hræŋi | hr~ENi	hræŋi 
sit: pɪpɪɲ 
skin: puɪn dɛl | puin dEl	puɪn dɛl 
sleep: bʊti 
small: θin 
smoke: ǯɪro | ǯɪro 
snake: tθwɛl 
stand: čuŋʔi 
star: čeːrɔ | Cero	čeːrɔ 
stone: kɪdi | kidi	kɪdi 
sun: čɛŋ | CEN	čɛŋ 
swim: kʷaŋi 
tail: ǯɪpʰ | ǯɪpʰ 
thin: oːdʷɛt 
this: man 
thou: iːnih | inih	iːnih 
thou: wuːni | inih	iːnih 
three: adɛguʔ 
tongue: lɛːpʰ | lEph~	lɛːpʰ 
tooth: leo 
tree: ǯɔtθ | jot8~ 
two: hario | arriɔ	hario 
walk: čiː 
warm: mɔr 
water: pʰi | ph~i	pʰi 
wet: θɛːč 
we: waːni | wani 
what: aginɛh 
white: tarr 
who: aŋah 
woman: θaːgo 
every: bɛd 
ash: bur 
abdomen: ɛtʲ 
bigness: duwɔŋ 
large: duwɔŋ 
breasts: 8u4o	θʊṇo 
nail: lwɛːdo 
talon: lwɛːdo 
come from: hoy	hɔy 
be dead: 8o	θɔː 
dead: 8o	θɔː 
left hand: Cino7	činɔʔ 
right: Cino7	činɔʔ 
1 sg.: anih	anɪh 
be knowledgeable: ŋeč 
head louse: nuwo 
male: θaːno 
much: θoːθ 
multiple: θoːθ 
several: θoːθ 
hill: kidi	kɪdi 
title: 5iN	nyɪŋ 
nighttime: wEr	wɛr 
nose: wum	wʊm 
adulterous: aCy~el	aciɛl	ačʲel 
single: aCy~el	aciɛl	ačʲel 
that: aCy~el	aciɛl	ačʲel 
the: aCy~el	aciɛl	ačʲel 
unprincipled: aCy~el	aciɛl	ačʲel 
human: 8ano 
human being: 8ano 
person: 8ano 
rainy weather: kʰɔtθ 
path: jo 
route: jo 
hide: puin dEl	puɪn dɛl 
little: θin 
smallness: θin 
rock: kidi	kɪdi 
2 sg: inih	iːnih 
you: inih	iːnih 
grind: arriɔ	hario 
hot: mɔr 
1 pl. inc.: wani 
we₁: wani 
whiteness: tarr 
who?: aŋah 
female: θaːgo 
