all: wulla 
ashes: wusi 
bark: qap 
belly: guzɨg | guezguiː	guzɨg 
big: wodel 
bird: čaɣa | čaɣa	čʔaɣaː 
bite: ɨŋ˗ɨŋ | iŋ	ɨŋ-ɨŋ 
black: tsarki 
blood: bɨri | b3ri	beriː	bɨri 
bone: ŋats | Nac	ŋats	ŋatsʔ	ŋatsʔiː 
breast: angʷ | anguiː	angw~	angʊ	angʷ 
burn: dɨŋust˗ 
claw: tsɛfɪr 
cloud: dummini 
cold: ɨɣumi 
come: ant˗ | ant	ant-	ant~	yent	yint 
die: kɨr | k3r	ke	ke-r	kɨr	kʔeː-r 
dog: gseŋ | g3seN	gesaːn	gesaːŋiː	gseN	gseŋ 
drink: zɨq˗ | z3q	zäkʔ	zɨq- 
dry: kagi 
ear: ɨnkoɣi | 3nkoxi	enkʔuaːɣiː	ɨnkoɣi 
eat: ɣu˗ŋ | kʔʊ	ɣu	ɣu-ŋ 
egg: ɨnkʷlal 
eye: ɨll | 3l	ɨll 
father: tabli 
fat (n.): mori 
fire: leg | leg	liägiː	läg 
fish: asi 
fly (n.): tsɨntsa 
foot: lɨkʷ | lúgue	lɨkʷ 
give: ɨy˗ | ayo	eː	ɨy- 
good: gud 
grass: siqwi 
hair: tsitsifi | tsitsifi	tsʔitsʔifiː 
hand: taf 
head: ŋari | aɣaː	ŋari	ŋariː 
hear: inkoɣ˗ | 3nkox	3nkw~ax	inkox	inkoɣ- 
heart: ɨšew | ɨšew 
horn: ǯenǯ | jenj	jenj~	ǯenǯ	ǯänǯiː 
I: an | an	ani	aniː	aŋ 
kill: ku˗ŋ | ku-ŋ	kuw	kʔuw 
knee: gulvi | g3r3b	gerbiː	gereb	gulvi 
know: (j)aq˗ | ak	aq-	jaq- 
leaf: ɣutsi | xaci	xuci	ɣutsi 
liver: gubbɛt | dolet	gubEt	gubbɛt 
long: liggisimi | liggisimi	lägäsem 
louse: yunti | yinti	yint~i 
man: ayi | akʔiː	aqi	axʷi	ayi 
many: ménǯ | ménǯ 
meat: ɨšši 
moon: arfa | arfa	arfaː 
mountain: kan 
mouth: ɣɨmbi 
name: sɨm | s3m	sɨm	šuːŋiː 
neck: gurgɨm 
new: ɨskawi | 3skawi	ɨskawi 
night: ɣar | xar	ɣar 
one: laɣu | 3mp3l	laxu	laɣu	lághu 
other: ɨlliw 
rain: ɨri 
red: dɨmmi | dɨmmi	sar 
road: dad 
root: sɨr | seriː	sɨr 
sand: ɣibtsi 
say: n˗ | dog	dokʔ	doɣ	n-	nog	nokʔu 
seed: zer 
see: kant˗ | kant	kant-	kant~ 
sit: ɨŋǯku˗ | ɨŋǯku- 
skin: ay 
sleep: ɣur˗ | ɣur- 
small: tsɨlli 
smoke: tɨša | tɨša 
snake: muri | mueriː	muri	mʊriː 
stand: tir˗ 
star: bewa 
stone: karɨŋ | kar3N	karɨŋ	kaːreŋ	kaːriŋ 
sun: awa 
swim: bamb˗ | bamb- 
tail: tsɨmar | tsɨmar	čʔäriː 
thin: ɨntsu 
this: ɨn 
thou: laŋa | 3nt	3nti	3nt~	ent	entiː	laŋa 
three: šuɣa 
tongue: tsaŋ | caN	tsaŋ 
tooth: ɨrkʷi | 3rkw~i	erkʔuiː	wekuiː	ɨrkʷi 
tree: kani 
two: laŋa | laNa	laŋa	lá. nga 
walk: kas˗ 
warm: ɨnkwani 
water: aɣu | aguoː	axu	axuː	aɣoː	aɣu 
we: ɨnnóǯi | 3noji 
wet: soɣen 
what: dar(ma) | dar	darma 
white: fučči | fučči 
who: ayi | ay	ayi 
woman: ɣuna | xunaː	xuʌnaː	ɣuna 
you: ɨntoǯi | 3nt	3nti	3nt~	ent	entiː	laŋa 
every: wulla 
ash: wusi 
abdomen: guezguiː	guzɨg 
bigness: wodel 
large: wodel 
breasts: anguiː	angw~	angʊ	angʷ 
nail: tsɛfɪr 
talon: tsɛfɪr 
come from: ant	ant-	ant~	yent	yint 
be dead: k3r	ke	ke-r	kɨr	kʔeː-r 
dead: k3r	ke	ke-r	kɨr	kʔeː-r 
full: wox 
left hand: taf 
right: taf 
1 sg.: an	ani	aniː	aŋ 
be knowledgeable: ak	aq-	jaq- 
head louse: yinti	yint~i 
male: ayi 
much: ménǯ 
multiple: ménǯ 
several: ménǯ 
hill: kan 
title: s3m	sɨm	šuːŋiː 
nighttime: xar	ɣar 
nose: 3san	ɨssan 
adulterous: 3mp3l	laxu	laɣu	lághu 
single: 3mp3l	laxu	laɣu	lághu 
that: 3mp3l	laxu	laɣu	lághu 
the: 3mp3l	laxu	laɣu	lághu 
unprincipled: 3mp3l	laxu	laɣu	lághu 
human: akʔiː	aqi	axʷi	ayi 
human being: akʔiː	aqi	axʷi	ayi 
person: akʔiː	aqi	axʷi	ayi 
rainy weather: ɨri 
path: dad 
route: dad 
hide: ay 
little: tsɨlli 
smallness: tsɨlli 
rock: kar3N	karɨŋ	kaːreŋ	kaːriŋ 
2 sg: 3nt	3nti	3nt~	ent	entiː	laŋa 
grind: laNa	laŋa	lá. nga 
hot: ɨnkwani 
1 pl. inc.: 3noji 
we₁: 3noji 
whiteness: fučči 
who?: ay	ayi 
female: xunaː	xuʌnaː	ɣuna 
