all: məkəǰaŋ | makejaN	makejang 
and: aǰak | muah 
animal: buron 
ashes: abu | aon 
back: tundun 
bad: ǰəle | beler	bələr 
bark: kulit 
because: apan 
belly: basaŋ | basaN	basang 
bird: kədis | k3dis	kedis	kədis 
bite: ñəgut (čəgut) | nyegut	ny~egut	ñəgut 
black: səbm | bad3N	badeN	badeng	badəŋ 
blood: gətih | getih	gətih 
blow: ŋ-upin | nyirsir 
bone: tulaŋ | tulaN	tulang 
breast: ñoño | nyonyo	ny~ony~o 
breathe: aŋkih-an | mangkihan 
burn: nuñǰəl (tuñǰəl) | morbor 
child: anak čənik 
cloud: guləm | gul3m	gulem	guləm 
cold: diŋin | diNin	dingin 
come: təkə | t3k3	t3ku	təku	təkə 
correct: bənəh 
count: mətek(pətek) | ngetek	ŋətɛk 
cut: nugəl (tugəl) | nugel	nugəl 
die: mati 
dig: (baŋbaŋ) | mlumbang	mlumbaŋ 
dirty: daki 
dog: čičiŋ | CiCiN	cicing	ciciŋ 
drink: ŋ-inəm | Ninem	nginem	ŋinəm 
dry: tuh 
dull: puntul | baat 
dust: buk 
ear: kupiŋ | kupiN	kuping 
earth: [gumi] | tanah 
egg: taluh 
empty: puyuŋ 
eye: matə | mata 
fall: tîpʷɔ | ulung 
far: ǰoh | joh 
father: bapə | bapa	bapə 
fat (n.): muluk 
fear: ǰəǰəh | takut 
few: bədik 
fingernail: ʔasa 
fire: api 
fish: be 
five: limə | lima	limə 
float: ŋambaŋ (kambaŋ) 
flower: buŋə | bunga 
flow: ŋ-əmbah | membah	məmbah 
fly (v.): mə-kəbər 
fog: limut 
foot: batis 
forest: alas 
four: pat | empat	patpat 
frog: katak 
fruit: [buah] | woh-wohan 
full: bək 
give: maaŋ (baaŋ) 
good: luuŋ | m3lah	melah	məlah 
grass: padaŋ | padang 
green: gadaŋ | gadaN	gadang 
guts: basaŋ | babetukan 
hair: bok 
hand: limə | lim3	lima	limə 
head: təndas | t3ndas	tendas	təndas 
hear: niŋəh (diŋəh) | niNeh	ningeh	niŋəh 
heart: (pə)pusuh-an 
heavy: baat 
he: iə 
hit: ñagur (ǰagur) | nyagur	ñagur 
horn: tanduk 
how: kenken 
hunt: mə-[boros] | maboros	məboros 
husband: No specific term | kurenan	kurənan 
ice: [es] 
if: [yen] 
I: [(i)čaŋ] | iCaN	icang 
in: (di) teŋah | di tengah	di təŋah 
kill: ŋə-mati-aŋ | N3matiyaN	NamatiaN	ngamatiang	ŋəmatiyang 
knee: əntud 
know: tau | tawaN	tawang 
lake: danu 
large: [gəde] | g3de	gede	gəde 
laugh: kədek | kedek	kədɛk 
leaf: don 
left: kebot 
leg: batis 
lie: mə-[sare] | N3bah	Nebah	ngebah	ŋəbah 
live: idup 
liver: ati 
long: dawə | daw3	dawa	dawə 
louse: kutu 
man: anak muani 
many: liu 
meat: isi 
moon: bulan 
mother: meme 
mountain: gunuŋ 
mouth: buŋut | bibin	bunnut 
name: adan 
narrow: čupit | cupek	cupək 
near: paək | paek	paək 
neck: baoŋ | baoN	baong 
new: marḳ | mar3	mara	marə 
night: Pətəŋ | p3t3N	peteN	peteng	pətəŋ 
nose: čuŋuh | CuNuh	cunguh 
old: tuə 
one: s(ə)- | sa 
person: anak 
play: mə-čandə 
pull: ŋədəŋ (kədəŋ) 
push: ñorog (sorog) 
rain: uǰan | ujan 
red: barak 
right: təŋawan | lim3	lima	limə | tengawan	təŋawan 
river: tukad 
road: [ruruŋ] | ruruN	rurung 
root: akah 
rope: tali 
rotten: bərək | bengu	bəŋu 
round: bundər 
rub: ñutsut (sutsut) 
salt: uyah 
sand: bias 
say: ŋ-[orah]-aŋ | NomoN	ngomong	nomoN	nomoŋ | bias 
sea: pasih 
seed: batu 
sew: ñait (ǰait) | nyait	ñait 
sharp: maŋan | mangan	maŋan 
short: bawak 
sing: gəndiŋ 
sit: nəgak  (təgak) | n3gak	negak	nəgak 
skin: kulit 
sky: laŋit | langit 
sleep: puləs | pul3s	puləs 
small: čənik | Cenik	cenik 
smell: ŋ-adək(-in) | ngadek	ŋadək 
smoke: andus 
smooth: bəlig 
snake: (Iə)lipi | lelipi 
spit: mə-kəčuh | mapees	məpəəs 
split: ñibak (sibak) | nyibak	ñibak 
stab: nəbək (təbək) | nebek	nəbək 
stand: mə-ǰuǰuk | majujuk | bias	majujuk 
star: biηtaŋ | bintaN	bintang 
stick: tuŋkəd | carang 
suck: ñə(p)səp  (sə(p)səp) | ngisep	ŋisəp 
sun: ai 
tail: ikut 
thick: təbəl | tebal	təbəl 
think: mə-kənəh | mekeneh	məkənəh 
thin: tipis 
thou: čai | Cai ajak mekejaN	cai 
three: təlu | telu	təlu 
throw: ñabat (sabat) | nylabatang 
tie: nəgul (təgul) | negul	nəgul 
tongue: layah 
tooth: gigi 
tree: puña-n kayu 
turn: madiŋaŋ 
two: duə | dadua	dua 
vomit: ŋ-utah | ngutah 
warm: kəbus | panes 
wet: bəlus | beseg	bəsəg 
what: apə | ap3	apa	apə 
when: pidan 
which: əñčen 
white: putih 
who: ñen | nyen	ny~en 
why: ŋudə 
wide: lombeŋ | linggah 
wind: aŋin | angin 
wing: kampid 
woman: anak luh 
worm: ǰlati | cacing 
wrong: pəlih 
year: tiban 
yellow: kuniŋ | kuniN	kuning 
every: makejaN	makejang 
ash: aon 
abdomen: basaN	basang 
big: g3de	gede	gəde 
bigness: g3de	gede	gəde 
breasts: nyonyo	ny~ony~o 
burn tr.: morbor 
come from: t3k3	t3ku	təku	təkə 
be dead: mati 
dead: mati 
ground: tanah 
land: tanah 
soil: tanah 
eat: daar	dar 
fat: muluk 
fat n.: muluk 
grease: muluk 
lubricant: muluk 
oil: muluk 
feather: bulu 
fly: m3k3b3r	makeber	məkəbər 
fly v.: m3k3b3r	makeber	məkəbər 
left hand: lim3	lima	limə 
1 sg.: iCaN	icang 
be knowledgeable: tawaN	tawang 
lie down: N3bah	Nebah	ngebah	ŋəbah 
head louse: kutu 
male: muani 
man: anak 
flesh: isi 
title: adan 
nighttime: p3t3N	peteN	peteng	pətəŋ 
not: tusiN 
adulterous: sa 
single: sa 
that: 3nto	ento	ənto 
the: sa 
unprincipled: sa 
human: anak 
human being: anak 
rainy weather: ujan 
path: ruruN	rurung 
route: ruruN	rurung 
see: niNalin	ningalin 
hide: kulit 
little: Cenik	cenik 
smallness: Cenik	cenik 
rock: batu 
stone: batu 
swim: NlaNi	nglangi 
this: 3ne	ene	əne 
2 sg: Cai ajak mekejaN	cai 
you: Cai ajak mekejaN	cai 
grind: dadua	dua 
go: m3jalan	majalan	məjalan 
walk: m3jalan	majalan	məjalan 
hot: panes 
water: yeh 
1 pl. inc.: ajak	iraga	jaN	jang	mak 
we: ajak	iraga	jaN	jang	mak 
we₁: ajak	iraga	jaN	jang	mak 
whiteness: putih 
who?: nyen	ny~en 
female: luh 
woman: luh 
distant: joh 
serious: baat 
close: paek	paək 
ner: paek	paək 
earthworm: cacing 
2 pl.: cai ajak mekejang 
ye: cai ajak mekejang 
you all: cai ajak mekejang 
3 pl.: in ajaka makojang 
they: in ajaka makojang 
where: dija	dijə 
where?: dija	dijə 
when?: pidan 
how?: kenken 
other: len 
broad: linggah 
wideness: linggah 
principal wife: kurenan 
wife: kurenan 
his mother: meme 
my mother: meme 
his father: bapa	bapə 
my father: bapa	bapə 
woods: alas 
branch: carang 
cord: tali 
gut: babetukan 
insides: babetukan 
intestine: babetukan 
intestines: babetukan 
breath: mangkihan 
laughter: kedek	kədɛk 
cogitate: mekeneh	məkənəh 
reflect: mekeneh	məkənəh 
sniff: ngadek	ŋadək 
afraid: takut 
be afraid: takut 
fright: takut 
alive: idup 
be alive: idup 
life: idup 
living: idup 
beat: nyagur	ñagur 
strike: nyagur	ñagur 
hack: nugel	nugəl 
cut open: nyibak	ñibak 
pierce: nebek	nəbək 
scratch: ngasgas	ŋasgas 
drop: ulung 
grasp: ngisi	ŋisi 
hold: ngisi	ŋisi 
hold in arm: ngisi	ŋisi 
squeeze: meseng	məsəŋ 
wring: meseng	məsəŋ 
bind: negul	nəgul 
fasten: negul	nəgul 
tie up: negul	nəgul 
enumerate: ngetek	ŋətɛk 
number: ngetek	ŋətɛk 
tally: ngetek	ŋətɛk 
ocean: pasih 
blaze: morbor 
evil: beler	bələr 
rot: bengu	bəŋu 
filthy: daki 
soiled: daki 
blunt: puntul 
damp: beseg	bəsəg 
right side: tengawan	təŋawan 
at: di	sig 
inside: di tengah	di təŋah 
if: yen 
