all: imese	nio siyose 
every: imese	nio siyose 
ash: panesea	tuwɔ 
ashes: panesea	tuwɔ 
bark: tama 
abdomen: nilo	nirɔ 
belly: nilo	nirɔ 
big: aunaie	auwɔna 
bigness: aunaie	auwɔna 
large: aunaie	auwɔna 
bird: pawa	siwi 
bite: igigisi 
black: gare gare	gareː 
blood: korimo	sawi	saᵘwi	sobi 
bone: soro	sɔrɔ 
breast: amo	amɔ	nono	omo 
breasts: amo	amɔ	nono	omo 
claw: tukupi 
nail: tukupi 
talon: tukupi 
cloud: tobore keʔikeʔi	tɔbɔtɔ bubu 
cold: kukamu	kukamɔ 
come: oro	oudia	oudie	ɔudie 
come from: oro	oudia	oudie	ɔudie 
be dead: araporaʔi	oisioi	oroburoi 
dead: araporaʔi	oisioi	oroburoi 
die: araporaʔi	oisioi	oroburoi 
dog: hiko	soka	soko	sɔka 
drink: odio 
dry: wapamotato 
ear: gare	gora 
earth: sopu	sɔpu 
ground: sopu	sɔpu 
land: sopu	sɔpu 
soil: sopu	sɔpu 
eat: iho	ɔuhu 
egg: iyopo	iɔpu 
eye: damari	domori	idimaliopu	idomori 
feather: musua	musuwa 
fire: ahi	aro	ela	mahi	mopi 
fish: nakere	nokara 
fly: ɔdau 
fly v.: ɔdau 
full: kiritomowoi	kirotomuwa	kirɔtɔmuwa 
give: abiɔtɔ	omia 
good: meana	parapaʔle 
green: gitigiti 
hair: epusume	sobo 
hand: tu	tu7u 
left hand: tu	tu7u 
right: tu	tu7u 
head: eputa	heputa 
hear: irowidiro	irowoi	irɔwidirɔ 
heart: giropu 
horn: goini	iowo 
1 sg.: mo	moʔo	mɔ 
I: mo	moʔo	mɔ 
kill: opia	rɔ ɔpia 
knee: kahwiɔ	kauhw~io	kaᵘhio	koupio	soiro koupio 
be knowledgeable: umoro	umɔrɔie 
know: umoro	umɔrɔie 
leaf: poara	pori	puara	puoro 
lie: utua	ɔrɔbu 
lie down: utua	ɔrɔbu 
liver: bau	beu 
long: tutulu	tuturu 
head louse: nimo 
louse: nimo 
male: dubu 
man: dubu 
many: sirioie	siriɔ 
much: sirioie	siriɔ 
multiple: sirioie	siriɔ 
several: sirioie	siriɔ 
moon: sogomi	sɔgɔmi 
hill: podo	pɔdɔ 
mountain: podo	pɔdɔ 
mouth: matago	matagɔrɔ 
name: masiro	masirɔ	mosiro 
title: masiro	masirɔ	mosiro 
neck: dɔpa	mau	turuturuʔo 
new: orio	ɔriɔ 
night: duwo	duwɔ 
nighttime: duwo	duwɔ 
nose: punugo	wodi	wɔdi 
not: puai	puaie 
adulterous: kaidi	koupoti	naidi	noidi	nopoe 
one: kaidi	koupoti	naidi	noidi	nopoe 
single: kaidi	koupoti	naidi	noidi	nopoe 
that: io	ioʔo 
the: kaidi	koupoti	naidi	noidi	nopoe 
unprincipled: kaidi	koupoti	naidi	noidi	nopoe 
human: dubu 
human being: dubu 
person: dubu 
rain: wesare	wisare 
rainy weather: wesare	wisare 
red: kaima karima	karima 
path: gabo	gobo 
road: gabo	gobo 
route: gabo	gobo 
root: sipi 
sand: nori 
say: nori 
see: eaᵘri	iauri	iouri	owao 
seed: iopu	iɔpu 
sit: omi	ɔmidirɔ 
hide: tama	tokomoi	tomo 
skin: tama	tokomoi	tomo 
sleep: uwo	uwɔ ɔrɔbu 
little: kainaʔi 
small: kainaʔi 
smallness: kainaʔi 
smoke: gahua	gahuwa 
star: kiboni	sari	suli	suri 
rock: depane	depani 
stone: depane	depani 
sun: saiki	saikio	saikiɔ	soiki 
swim: iowa	ɔbɔ iɔuwa 
tail: kukau	wapo 
this: noᵘwe	nɔuʔu 
2 sg: oro	ɔrɔ 
thou: oro	ɔrɔ 
you: oro	ɔrɔ 
tongue: otopele	ototoba	ototobe	ɔtɔtɔbe 
tooth: ibomoro	ibonoro	ibɔmɔtɔ 
tree: ota	oto 
grind: natawo taibo	natowo	netewa taibo	netewa taibɔ	netoa	notatepo 
two: natawo taibo	natowo	netewa taibo	netewa taibɔ	netoa	notatepo 
go: ɔuʔu 
walk: ɔuʔu 
water: obo	ɔbɔ 
1 pl. inc.: neio	nimo 
we: neio	nimo 
we₁: neio	nimo 
what: didara	tɔura 
white: kea	kea saɔ 
whiteness: kea	kea saɔ 
who: etura	otura 
who?: etura	otura 
female: worobo	ɔrɔbɔ 
woman: worobo	ɔrɔbɔ 
yellow: ago ago	aguwagɔ 
