all: kuːd 
ashes: t̪aːd̪iŋ 
bark: pɔtɛka 
belly: buli 
big: d\aːŋke | dʼaːŋke 
bird: denɛt̪ 
bite: akaǯar | akaǯar 
black: ɔləʔɔl 
blood: remat̪ | remat	remat̪ 
bone: žwəd̪ | Zw~3d	žwəd̪ 
breast: t̪enit̪ | tenit	t̪enit̪ 
burn: elde 
claw: kɔrkɔn 
cloud: kɔl 
cold: yɛmit̪ 
come: ədit | 3dir	ədit 
die: tɔbbe | tobe	tɔbbe 
dog: gɔk | gok	gɔk 
drink: matar 
dry: aʔawin 
ear: idi 
eat: amed̪ 
egg: kɔmat 
eye: wəŋ | w3N	wəŋ 
father: baba 
fat (n.): ačaßɔn 
fire: mač | maC	mač 
fish: rɛč | rEC	rɛč 
fly (n.): laŋʲɛt 
foot: kerɛ 
give: iŋir 
good: pat̪upat̪ 
grass: lom 
hair: re 
hand: enat̪ | enat	enat̪ 
head: weč | weč 
heart: čɔdɛ | čɔdɛ 
hear: tɛŋgɛ | tENg~E	tɛŋgɛ 
horn: tuŋe | tuNe	tuŋe 
I: aːneč | aneC	aːneč 
kill: nagadɔk 
know: ŋɛðar 
leaf: kɔd̪ak | kodak	kɔd̪ak 
liver: kenət̪ | ken3t	kenət̪ 
long: bər(ə)bɔr | bərbɔr	bərəbɔr 
louse: yək | y3k 
man: t̪aːrɔk | tarok 
many: aːkɔdɔŋ 
meat: kɔgɔk 
moon: paːč | paːč 
mountain: pəm | p3m	pəm 
mouth: tɔk 
name: mɔŋɔn | moNon	mɔŋɔn 
neck: d\ɔk | dʼɔk 
new: akeč | akeC	akeč 
night: aban 
one: akɛl | akEl	akel	akɛl 
other: ɔkan 
rain: kɔt 
red: mɛɲmɛɲ 
road: pɔr | por 
root: berit̪ 
sand: teŋɔl 
say: ǯayar | ǯayar 
seed: kab 
see: ɔukuðar | ouku8ar	ɔukuðar 
sit: kekɛr 
skin: rɔdɛ | rodE	rɔdɛ 
sleep: nene 
small: lɛke 
smoke: rɛt̪ 
snake: nanaːn 
stand: yɔdɛ 
star: kɛtɛnɛt | kEtEnEt	kɛtɛnɛt 
stone: gurit 
sun: əŋ | 3N	əŋ 
swim: kaŋ 
tail: ßele | βele 
thin: bombom 
this: ɛn 
thou: eneč | eneC	eneč 
three: adak 
tongue: lɛbɛ | lEbE	lɛbɛ 
tooth: legit 
tree: yat̪ 
two: are | are	areo 
walk: adɛr 
warm: miǯmiǯ | miǯmiǯ 
water: pi 
we: ɔnɔk | onok 
wet: taǯaːtaǯ 
what: ŋə 
white: baːbɔ 
who: ŋa 
woman: mɛnmarak 
every: kuːd 
ash: t̪aːd̪iŋ 
abdomen: buli 
bigness: dʼaːŋke 
large: dʼaːŋke 
breasts: tenit	t̪enit̪ 
nail: kɔrkɔn 
talon: kɔrkɔn 
come from: 3dir	ədit 
be dead: tobe	tɔbbe 
dead: tobe	tɔbbe 
left hand: enat	enat̪ 
right: enat	enat̪ 
1 sg.: aneC	aːneč 
be knowledgeable: ŋɛðar 
head louse: y3k 
male: t̪aːrɔk 
much: aːkɔdɔŋ 
multiple: aːkɔdɔŋ 
several: aːkɔdɔŋ 
hill: p3m	pəm 
title: moNon	mɔŋɔn 
nighttime: aban 
nose: oman 
adulterous: akEl	akel	akɛl 
single: akEl	akel	akɛl 
that: akEl	akel	akɛl 
the: akEl	akel	akɛl 
unprincipled: akEl	akel	akɛl 
human: tarok 
human being: tarok 
person: tarok 
rainy weather: kɔt 
path: por 
route: por 
hide: rodE	rɔdɛ 
little: lɛke 
smallness: lɛke 
rock: gurit 
2 sg: eneC	eneč 
you: eneC	eneč 
tree: yat 
grind: are	areo 
hot: miǯmiǯ 
1 pl. inc.: onok 
we₁: onok 
whiteness: baːbɔ 
who?: ŋa 
female: mɛnmarak 
