all: ac̷̣onuka	azonuca 
every: ac̷̣onuka	azonuca 
ash: fusque	sucta	sukta	βuske 
ashes: fusque	sucta	sukta	βuske 
bark: huca	huka 
big: cuhuma	kuhuma 
bigness: cuhuma	kuhuma 
large: cuhuma	kuhuma 
bird: sue 
bite: c̷̣ɨ-mon-suka	zemonsuca 
black: a-mɨhɨc̷̣-ɨn maɣe	amuyhyzyn mague 
blood: h3ba	hyba	hɨβa 
bone: ku3ne	kuɨne	quyne 
breast: Suhupkua	chuhupqua	suhupka	ṣuhupkua 
breasts: Suhupkua	chuhupqua	suhupka	ṣuhupkua 
cloud: faoa	βaoa 
cold: c̷̣ɨ-kɨ-en-suka	zquyensuca 
come: c̷̣ɨ-hu-skua	huskua	zehusqua 
come from: c̷̣ɨ-hu-skua	huskua	zehusqua 
be dead: bgye	bx~3e	βɣɨe 
dead: bgye	bx~3e	βɣɨe 
die: bgye	bx~3e	βɣɨe 
dog: to 
drink: biohot3	c̷̣ɨ-β-iohotɨ-suka	zebiohotysuca 
dry: buchua	βuṣua 
ear: cuhuca	kuhuka 
earth: kɨka	quyca 
ground: kɨka	quyca 
land: kɨka	quyca 
soil: kɨka	quyca 
eat: c̷̣ɨ-kɨṣɨkɨ-suka	zequychyquysuca 
eye: upkua	upqua 
feather: gaca	ɣaka 
fire: gata	xata	ɣata 
fish: gua	xua	ɣua 
foot: kihiṣa	quihicha 
full: ies asucune	ies asukune 
give: hoc mnysqua	hok β-nɨ-skua 
good: cho	ṣo 
green: a-ṣɨsk-ɨn maɣe	achysquyn mague 
hair: c̷̣ɨe	zye 
hand: 3ta	yta	ɨta 
left hand: 3ta	yta	ɨta 
right: 3ta	yta	ɨta 
head: c̷̣ɨs-kɨ	zysquy 
hear: bn3kua	mnyqua-suca	β-nɨ-kua-suka 
heart: nymsuguy	nɨmsuɣɨ 
horn: ku3h3e	kuɨhɨe	quyhye 
1 sg.: h3Sa	h3sa	hycha	hɨṣa 
I: h3Sa	h3sa	hycha	hɨṣa 
kill: bgusqua	β-ɣu-skua 
knee: gota	xota	ɣota 
be knowledgeable: c̷̣ɨ-β-ukan-suka	zemucansuca 
know: c̷̣ɨ-β-ukan-suka	zemucansuca 
leaf: k3e	k3eka	kɨe	quye 
lie: ybcac izone	ɨ-βka-k i-c̷̣one 
lie down: ybcac izone	ɨ-βka-k i-c̷̣one 
liver: t3h3ba	tyhyba	tɨhɨβa 
long: gahasio	ɣahasio 
head louse: cue	cumne	kue	kumne 
louse: cue	cumne	kue	kumne 
male: muysca	mɨska 
man: m3ska	muysca	mɨska 
many: fie	βie 
much: fie	βie 
multiple: fie	βie 
several: fie	βie 
flesh: chimy	ṣimɨ 
meat: chimy	ṣimɨ 
moon: chie	ṣie 
hill: gua	xua	ɣua 
mountain: gua	xua	ɣua 
mouth: guyhyca	ɣɨhɨka 
name: h3ka	hyca	hɨka 
title: h3ka	hyca	hɨka 
neck: gyquihicha	ɣɨ-kihiṣa 
new: bihica	bihiza	fihiza	βihic̷̣a 
night: ca	c̷̣a	za 
nighttime: ca	c̷̣a	za 
nose: saca	saka 
adulterous: ata 
one: ata 
single: ata 
that: ata 
the: ata 
unprincipled: ata 
human: m3ska	muysca	mɨska 
human being: m3ska	muysca	mɨska 
person: m3ska	muysca	mɨska 
rain: siu 
rainy weather: siu 
red: heczen mague	hekc̷̣-ɨn maɣe 
root: chihiza	ṣihic̷̣a 
round: a-toβoka	atoboca 
sand: guanza	ɣua-nc̷̣a 
say: c̷̣ɨ-ɣu-skua	zegusqua 
see: bist3	c̷̣ɨ-β-istɨ-suka	zemistysuca 
seed: sune 
sit: hichan izasqua	hiṣa-n i-c̷̣a-skua 
hide: huca	huka 
skin: huca	huka 
sleep: c̷̣ɨ-kɨβɨ-suka	zquybysuca 
little: inguezunga	inɣe-c̷̣unɣa 
small: inguezunga	inɣe-c̷̣unɣa 
smallness: inguezunga	inɣe-c̷̣unɣa 
smoke: ie 
star: baxua	fagua	βaɣua 
rock: h3ka	hyca	hɨka 
stone: h3ka	hyca	hɨka 
sun: sua 
swim: inyhyz agosqua	inɨhɨc̷̣ a-ɣo-skua 
tail: suhuca	suhuka 
2 sg: mue 
thou: mue 
you: mue 
tongue: pkua	pqua 
tooth: sica	sika 
tree: k3e 
grind: boca	botsa	boza	βoc̷̣a 
two: boca	botsa	boza	βoc̷̣a 
go: i-es i-na-skua	ies inasqua 
walk: i-es i-na-skua	ies inasqua 
hot: a-ɣe-n-suka	aguensuca 
warm: a-ɣe-n-suka	aguensuca 
water: sie 
1 pl. inc.: Sie	sie 
we: Sie	sie 
we₁: Sie	sie 
what: ipkua	ipqua 
white: pkɨhisio	pquyhisio 
whiteness: pkɨhisio	pquyhisio 
who: sie-ua	xieoa 
who?: sie-ua	xieoa 
female: muysca fucha	mɨska βuṣa 
woman: muysca fucha	mɨska βuṣa 
yellow: a-tɨβan-suka	atybansuca 
distant: a-huen maɣe	ahuen mague 
far: a-huen maɣe	ahuen mague 
dull: a-βihic̷̣-ɨn maɣe	afihizan mague 
heavy: a-βihic̷̣-ɨn maɣe	afihizan mague 
serious: a-βihic̷̣-ɨn maɣe	afihizan mague 
close: hischcatan	hiṣkata-n 
near: hischcatan	hiṣkata-n 
ner: hischcatan	hiṣkata-n 
salt: nygua	nɨɣua 
short: a-suhuka-c̷̣a	asuhucaza 
snake: muyso aquyca gue	mɨso akɨka ɣe 
thin: a-siten maɣe	asiten mague 
wind: fiba	βiβa 
earthworm: ona	sosua 
worm: ona	sosua 
year: c̷̣okam-	zocam 
2 pl.: mie 
ye: mie 
you all: mie 
3 pl.: asy	asɨ 
they: asy	asɨ 
where: epkua-k ua	epquac oa 
where?: epkua-k ua	epquac oa 
when: fesnua	fesua	βes-n-ua	βes-ua 
when?: fesnua	fesua	βes-n-ua	βes-ua 
how: ia hacobe	ia hacoua	ia hako-ua 
how?: ia hacobe	ia hacoua	ia hako-ua 
some: ipkuaβie	ipquabie 
few: fiquenza	βike-nc̷̣a 
three: mica	mika 
four: mhuyzca	muyca	mɨhuɨc̷̣ka 
five: hycsa	hyzca	hɨc̷̣ka 
broad: a-βihista ɣe	afihista gue 
wide: a-βihista ɣe	afihista gue 
wideness: a-βihista ɣe	afihista gue 
fat: a-ṣimɨ ɣe	achimy gue 
thick: a-ṣimɨ ɣe	achimy gue 
narrow: a-βihista-c̷̣a	afihistaza 
child: guasgua cha	ɣuasɣua ṣa 
principal wife: gui	ɣi 
wife: gui	ɣi 
husband: sahaoa	saoa 
his mother: guaia	ɣuaia 
mother: guaia	ɣuaia 
my mother: guaia	ɣuaia 
father: paba	pabi	paβa	paβi 
his father: paba	pabi	paβa	paβi 
my father: paba	pabi	paβa	paβi 
forest: kɨe	quye 
woods: kɨe	quye 
branch: kɨeka	quyeca 
stick: kɨeka	quyeca 
fruit: kɨe-uβa	quyeuba 
flower: uba	uβa 
grass: kɨkhɨkɨ	quychquy	quyhyquy 
cord: chihize	ṣihic̷̣e 
rope: chihize	ṣihic̷̣e 
claw: ytyua	ɨtɨ-βa 
fingernail: ytyua	ɨtɨ-βa 
nail: ytyua	ɨtɨ-βa 
leg: goca	ɣoka 
wing: gaca	ɣaka 
gut: c̷̣imsua	zimsua 
guts: c̷̣imsua	zimsua 
insides: c̷̣imsua	zimsua 
intestine: c̷̣imsua	zimsua 
intestines: c̷̣imsua	zimsua 
back: gutaquyn	ɣuta-kuɨn 
suck: -β-ṣuṣɨ-suka	bchuchysuca 
spit: c̷̣ɨ-kɨhɨc̷̣-ɨɣo-skua	zquyhyzygosqua 
vomit: bcosqua	βko-skua 
blow: obas bcusqua	oβas β-ku-skua 
breath: fihizca	βihic̷̣ka 
breathe: fihizca	βihic̷̣ka 
laugh: c̷̣ɨ-ɣɨɣua-suka	zegyguasuca 
laughter: c̷̣ɨ-ɣɨɣua-suka	zegyguasuca 
cogitate: ybunsuca	ɨ-βun-suka 
reflect: ybunsuca	ɨ-βun-suka 
think: ybunsuca	ɨ-βun-suka 
smell: c̷̣ɨ-β-ɨskɨ-suka	zmuysquysuca 
sniff: c̷̣ɨ-β-ɨskɨ-suka	zmuysquysuca 
afraid: bsiesesuca	β-siese-suka 
be afraid: bsiesesuca	β-siese-suka 
fear: bsiesesuca	β-siese-suka 
fright: bsiesesuca	β-siese-suka 
alive: c̷̣-ika	m-ika	mica	zica 
be alive: c̷̣-ika	m-ika	mica	zica 
life: c̷̣-ika	m-ika	mica	zica 
live: c̷̣-ika	m-ika	mica	zica 
living: c̷̣-ika	m-ika	mica	zica 
fight: c̷̣ɨ-ka-skua	zecasqua 
hunt: c̷̣ɨ-kuɣo-skua	zecugosqua 
beat: ys bgyisuca	ɨs-β-ɣɨi-suka 
hit: ys bgyisuca	ɨs-β-ɣɨi-suka 
strike: ys bgyisuca	ɨs-β-ɣɨi-suka 
cut open: sacan btasqua	sakan -β-ta-skua 
split: sacan btasqua	sakan -β-ta-skua 
dig: -β-kɨhɨu-suka	bquyhyusuca 
tell lies: yenza	ɨe-nc̷̣a 
stand: kɨpkua-s c̷̣ɨ-pkuan-suka	quypquas zpquansuca 
turn: ys zukuscansuca	ɨs c̷̣-uhuska-n-suka 
turn around: ys zukuscansuca	ɨs c̷̣-uhuska-n-suka 
turn round: ys zukuscansuca	ɨs c̷̣-uhuska-n-suka 
drop: c̷̣ɨ-βenan-suka	zebenansuca 
fall: c̷̣ɨ-βenan-suka	zebenansuca 
grasp: cam bquysqua	kam β-kɨ-skua 
hold: cam bquysqua	kam β-kɨ-skua 
hold in arm: cam bquysqua	kam β-kɨ-skua 
squeeze: c̷̣ɨ-β-io-skua	zbiosqua 
wring: c̷̣ɨ-β-io-skua	zbiosqua 
wash: -β-ṣuhu-skua	bchuhusqua 
wash clothes: -β-ṣuhu-skua	bchuhusqua 
throw: yc btasqua	ɨkɨ -β-ta-skua 
bind: -β-kamɨ-suka	bcamysuca 
fasten: -β-kamɨ-suka	bcamysuca 
tie: -β-kamɨ-suka	bcamysuca 
tie up: -β-kamɨ-suka	bcamysuca 
sew: -isinɨɣo-skua	ixinygosqua 
count: bgytysuca	β-ɣɨtɨ-suka 
enumerate: bgytysuca	β-ɣɨtɨ-suka 
number: bgytysuca	β-ɣɨtɨ-suka 
tally: bgytysuca	β-ɣɨtɨ-suka 
sing: btysqua	βtɨ-skua 
have fun: c̷̣ɨ-pkuac̷̣ɨɣo-skua	zpquazygosqua 
play: c̷̣ɨ-pkuac̷̣ɨɣo-skua	zpquazygosqua 
flow: a-kosɨn-suka	acosynsuca 
brook: sie	sie-toke	sietoque	xie 
river: sie	sie-toke	sietoque	xie 
stream: sie	sie-toke	sietoque	xie 
lake: si-ua	xiua 
dust: fusque	βuske 
fog: faoa	βaoa 
sky: guatquyca	ɣuat-kɨka 
snow: hichu	hiṣu 
day: sua 
daylight: sua 
daytime: sua 
bad: a-ṣue-nc̷̣a	achuenza 
evil: a-ṣue-nc̷̣a	achuenza 
rot: a-ɣahaṣan-suka	agahachansuca 
rotten: a-ɣahaṣan-suka	agahachansuca 
dirty: a-mɨhɨc̷̣-ɨn maɣe	amuyhyzen mague 
filthy: a-mɨhɨc̷̣-ɨn maɣe	amuyhyzen mague 
soiled: a-mɨhɨc̷̣-ɨn maɣe	amuyhyzen mague 
straight: pkihic̷̣u-k c̷̣ona	pquihizuc zona 
sharp: a-sika-c̷̣ β-kɨ-skua	asicaz bquysqua 
smooth: c̷̣ɨ-β-ohosɨ-suka	zmohosysuca 
damp: iotu-pkua	iotupqua 
wet: iotu-pkua	iotupqua 
right side: yta cho	ɨta ṣo 
left: c̷̣-uin apkua-k a-ɣe	zuin apquac ague 
in: huia	huie 
inside: huia	huie 
and: nga	nɣa 
because: npkua-ka	npquaca 
