all: puː	čyɛm 
every: puː	čyɛm 
ash: dwẽ	dʷɛ̃ 
ashes: dwẽ	dʷɛ̃ 
bark: bamu 
big: gabru	golembo 
bigness: gabru	golembo 
large: gabru	golembo 
bird: aɲan	ʔɑŋɑn 
bite: čɛda 
black: gɛmɛ	ǯɛmɛ 
blood: gy~ENgy$u	gyɛŋgyu	ǯĩǯu 
bone: kina	čina 
breast: EmE	ɛmɛ 
breasts: EmE	ɛmɛ 
cloud: kulbala	kurubɛrɛ 
cold: keži 
come: wo	wɔ 
come from: wo	wɔ 
be dead: tEbE	tɛbɛ	tⁱbɛ 
dead: tEbE	tɛbɛ	tⁱbɛ 
die: tEbE	tɛbɛ	tⁱbɛ 
dog: ngy$E	ngyɛ	ŋǯɛ 
drink: 5a	nⁱa	ɲa 
ear: sun 
earth: doy 
ground: doy 
land: doy 
soil: doy 
eat: nya	ɲa 
egg: tolu	toːl 
eye: gide	ǯidie 
feather: kula 
fire: golo	gʷolo 
fish: izu	ʔizu 
fly: kiːyu	čilio 
fly v.: kiːyu	čilio 
foot: tɛmbɛn 
full: ba 
give: ndi	ndⁱ 
good: sⁱe	ɛl 
green: wɛr 
hair: kula 
head: ko	kʷɔ 
hear: ninǯu	no	nɔ 
heart: kinda duga	činda 
horn: kElE	kɛlɛ 
1 sg.: mi	mⁱ 
I: mi	mⁱ 
kill: gya	ǯa 
knee: kunzu	kunz~u 
be knowledgeable: zwa	zᵘɔ 
know: zwa	zᵘɔ 
leaf: kula	kulɔ 
liver: kinda	kind~a 
long: zala	žalaŋ 
head louse: seme 
louse: seme 
male: an	anmu	ʔan	ʔɑn 
man: no	numɔ	ʔno 
many: kalezon	kɑⁱənu 
much: kalezon	kɑⁱənu 
multiple: kalezon	kɑⁱənu 
several: kalezon	kɑⁱənu 
moon: swa	sʷa 
hill: koNo 
mountain: koNo 
mouth: kyɛnɛ	čɛnːɛ 
name: in	noʔin	ín 
title: in	noʔin	ín 
neck: kɔlɔ	kʷɔlɔ 
night: dEnd~a	dɛnda 
nighttime: dEnd~a	dɛnda 
nose: kinza	kinz~a	čɩnzaː 
not: ?-zon 
adulterous: tuma	tumaː 
one: tuma	tumaː 
single: tuma	tumaː 
that: kuba	ʔɑŋɛ 
the: tuma	tumaː 
unprincipled: tuma	tumaː 
human: no	numɔ	ʔno 
human being: no	numɔ	ʔno 
person: no	numɔ	ʔno 
rain: anuŋ	ʔanŋu 
rainy weather: anuŋ	ʔanŋu 
red: ban	bɑn 
path: ozu 
road: ozu 
route: ozu 
root: dil	dilu 
sand: sɔnsɔm	sɔnzɔm 
say: dama 
see: tⁱǯa	wa 
seed: é	čitɔŋɔ 
hide: guzu 
skin: guzu 
sleep: gidɛn	gipɛn	nⁱy 
little: dumbi	čⁱmsaⁱ 
small: dumbi	čⁱmsaⁱ 
smallness: dumbi	čⁱmsaⁱ 
smoke: kumu 
star: sənakɛlɛ	tondolo	tond~olo 
rock: kin	čin 
stone: kin	čin 
sun: izige 
swim: bugu	bɛmba 
tail: dulɔ	dulʷə 
this: bo	yɛ 
2 sg: ɔ	ʔɔ 
thou: ɔ	ʔɔ 
you: ɔ	ʔɔ 
tongue: nEmda	nɛmda 
tooth: in	ín	ʔin 
tree: time 
grind: no	nɔː	ⁱenoː 
two: no	nɔː	ⁱenoː 
go: un	ʔun 
walk: un	ʔun 
water: Ngy$u	nǯu	ŋgyu 
1 pl. inc.: yE 
we: yE 
we₁: yE 
what: kinyema 
white: pile	pⁱlɛ 
whiteness: pile	pⁱlɛ 
who: ʔam 
who?: ʔam 
female: yɛ	yɛmu 
woman: yɛ	yɛmu 
yellow: lɔl punɔ 
distant: wagi	ʷɑǯu 
far: wagi	ʷɑǯu 
dull: tuǯu 
heavy: tuǯu 
serious: tuǯu 
close: bɛdiu 
near: bɛdiu 
ner: bɛdiu 
salt: nem	nɩm 
short: dene	dumbi 
snake: numzu 
thin: mɛnzi	mɛzo 
wind: ɛnɛŋ	ʔɩnɩŋ 
year: ana gudin 
