animal: pɪ́ɔ́ːrɔk | pɪ́ɔ́ːrɔk 
arm: k˗ʊmmʊ 
ashes: kɔrɔ́ŋ | kɔrɔ́ŋ 
back: k˗ɔ́ːk | k-ɔ́ːk 
bad: ˗aːgi | -aːgi 
bark: kiɲɲ́i | kiɲɲ́i 
belly: č˗áːrik | č-áːrik 
big: ˗b̥b̥îk | -b̥b̥îk 
bird: ŋ˗ʊ́rʊ̯́ße | ŋ-ʊ́rʊ̯́βe 
bite: pá˗magɔ́yɔ́ | pá-magɔ́yɔ́ 
black: ˗ɛ́ndí | -ɛ́ndí 
blood: ŋíruk̥ | Niruk	ŋíruk̥ 
blow: ɛːrʊ 
bone: čʊmmɛ | Tumma	čummʷɛ	čʊmmɛ 
bone: čummʷɛ | Tumma	čummʷɛ	čʊmmɛ 
branch: t̪˗ɪ́k | t̪-ɪ́k 
breast: inǯik | TinT~ik	inǯik 
breathe: pa˗ná duhɔ́ 
brother: paámbîŋ 
burn: pɛːdék̥ 
child: ɲárɛ̂k | ŋʊ́rik	ɲárɛ̂k 
child: ŋʊ́rik | ŋʊ́rik	ɲárɛ̂k 
claw: k˗áːdɛdɛ | k-áːdɛdɛ 
cloud: k˗ǎy(í)ri | k-ǎyri	k-ǎyíri 
cold: it̪t̪îŋ | it̪t̪îŋ	ŋ- 
cold: ŋ˗ | it̪t̪îŋ	ŋ- 
come: ájɔ́ | aku	akū!	ájɔ́ 
come: aku̒ǃ | aku	akū!	ájɔ́ 
correct: appʊŋ | -attiŋ	appʊŋ 
correct: ˗attiŋ | -attiŋ	appʊŋ 
count: táŋáːndu | táŋáːndu 
cut: kɛɛ́gi | kɛɛ́gi 
cut: tɔkʷaǃ | kɛɛ́gi 
day: č˗iŋgi | tí-ǯɪ́ŋgi	tí-ɪ́ŋgi 
day: tí˗(ǯ)ɪ́ŋgi | tí-ǯɪ́ŋgi	tí-ɪ́ŋgi 
die: p˗ɪ́ːŋɔ | p-ɪ́ːŋɔ	piNo 
dig: kíːgʊǃ | kíːgʊ! 
dirty: aːnu˗ŋírí | aːnu-ŋírí 
dog: aːbʊk | aːbʊk	poak	pɔak 
dog: pɔak | aːbʊk	poak	pɔak 
drink: ɛːgʊ | agu	iagu	ɛːgʊ 
dry: andok 
ear: kéːnú | kanu	kéːnú 
earth: p˗úl(ú)ga̒k 
eat: lɔgɔ́ǃ | lɔgɔ́! 
egg: ʷûyŋ | ʷûyŋ 
eye: r˗ɪ́ik | Tik	r-ɪ́ik 
fall: pa˗rɪ́ŋgɔ | pa-rɪ́ŋgɔ 
far: čɪ́ttaŋ | čɪ́ttaŋ 
father: abba | -bɛ́	abba 
father: ˗bɛ́ | -bɛ́	abba 
fat (n.): ŋáak 
fear: p˗ana˗dɛːráŋ | p-ana-dɛːráŋ 
feather: č˗ádáːlaŋ | č-ádáːlaŋ 
few: âttɪ́k | âttɪ́k 
fight: kɔ́tuǃ | kɔ́tu! 
finger: čaːdak 
fingernail: k˗áːdɛdɛ | k-áːdɛdɛ 
fire: t˗ɪ́k | t-ɪ́k	tik 
fish: k˗áːßɛ | k-áːβɛ	kaba 
five: čißiɲ čállâŋ | ciβiñ cállâŋ	čiβiɲ čállâŋ 
flower: č˗ʊlɔ | č-ʊlɔ 
flow: ŋí ŋa˗mʊtʊ́ndá | ŋí ŋa-mʊtʊ́ndá 
fly (n.): g˗ʊ́ːrʊ 
fog: č˗ʊ́ːli | č-ʊ́ːli 
foot: čígâk | čígâk 
forest: tʊ́k | tʊ́k 
four: ˗ib̥b̥ɪ́ɲik | -ib̥b̥í̄ik	-ib̥b̥ɪ́ɲik 
fruit: ŋ˗ʊ́rik | ŋ-ʊ́rik 
full: ˗aßʊ́ya | -aβʊ́ya	yabuya 
good: ˗attiŋ | -attiŋ 
grass: čaːßak | čaːβak 
green: aːyi(k̥) | aːyi	aːyik̥ 
guts: tʊǯʊk | tʊǯʊk 
hair: t˗ūŋûŋ | t-ūŋûŋ 
hand: č˗ibiŋ | TibiN	č-ibiŋ 
head: č˗a | č-a	č-am 
head: č˗am | č-a	č-am 
hear: mɛːdʊǃ | madu	mɛːdʊ! 
heart: č˗ígî | č-ígî 
heavy: ˗ammî | -ammî 
hit: lɪ́waǃ | lɪ́wa! 
hole: č˗itik 
horn: t̪ʊ́ːßîk | tubik	t̪ʊ́ːβîk 
hunt: (ŋ́gɔ) čɛtɔ́ː | čɛtɔ́ː	ŋ́gɔ čɛtɔ́ː 
husband: pɛrɛ pɪ́n | pɛrɛ pɪ́n 
I: aɲɪ́ | a5i	aɲɪ́ 
kill: kɔßɔ́d̪aǃ | kɔβɔ́d̪a! 
knee: k˗ʊŋgʊ | k-ʊŋgʊ	kuNg~u 
know: banna 
laugh: ŋaːlwɛ́kǃ | ŋaːlwɛ́k! 
leaf: t˗aːd̪á | t-aːd̪á	tada 
left: ˗agʊ́lɛ | -agʊ́lɛ 
leg: č˗ɪ́gâk | č-ɪ́gâk 
lie: ɲaŋgɔ́d̪ɛǃ | ɲaŋgɔ́d̪ɛ! 
live: p˗aːrá˗ná | p-aːrá-ná	p-ʊnda 
live: p˗ʊnda | p-aːrá-ná	p-ʊnda 
liver: t̪˗ʊ́ŋgi | tuNg~i	t̪-ʊ́ŋgi 
long: ʊččɪ(ɛ) | ʊččɪ	ʊččɪɛ 
louse: t˗ʊːdɛ | tuda 
man: p˗ʊrʊk | p-ʊrʊk̥	puruk 
many: ˗íččɔ̂ | -íččɔ̂ 
meat: áːbâ | áːbâ 
moon: k˗áːnu(k̥) | k-áːnu	k-áːnuk̥ 
mother: nɛːmbɛ̄ 
mountain: k˗ɔ̂ | k-ɔ̂	ko 
mouth: t˗ɔ̂ŋ | t-ɔ̂ŋ 
name: k˗alaŋa(ŋ) | k-alaŋa	k-alaŋaŋ	kalaNa	kalaNaN 
narrow: ˗kúlúndɛ | -kúlúndɛ 
near: nándɔ́ŋɔččɔ́ | nándɔ́ŋɔččɔ́ 
neck: čandak | čandak 
new: ˗áːyɛ̂ | -áːyɛ̂	aya 
night: n˗ɔ́ŋgɔ́ːda | n-ɔ́ŋgɔ́ːda	noNg~oda 
old: ˗ɔːb̥b̥î 
one: ˗állâŋ | -állâŋ	tallaN 
person: p˗ʊrʊk̥ | p-ʊrʊk̥	puruk 
play: ɲáːra˗nogʊ́tûk | ɲáːra-nogʊ́tûk 
pull: pɪ́tyaǃ 
push: ɪ́ːŋʷâǃ 
rain: pɛnɛ 
red: ˗ʊttɛ́ | -ʊttɛ́ 
right: ˗ariŋ | TibiN	č-ibiŋ | -ariŋ 
river: ʊ́ːrʊ́k | ʊ́ːrʊ́k 
road: áːd̪ɪ̂ | kadi 
root: t̪˗ʊga | t̪-ʊga 
rope: t̪˗ɔːrʊk | t̪-ɔːrʊk 
rotten: ya˗ɲʊ́rʊta | ya-ɲʊ́rʊta 
round: ya˗yɛ́rɔtɔ | ya-yɛ́rɔtɔ 
rub: t̪ɔːge̯aǃ | t̪ɔːge̯a! 
salt: č˗alá | č-alá 
sand: p˗ʊ́ːrɛ(ŋ) | p-ʊ́ːrɛ	p-ʊ́ːrɛŋ 
say: ʊːgaǃ | ʊːga! | p-ʊ́ːrɛ	p-ʊ́ːrɛŋ 
say: p˗aná˗yambɔ́ | ʊːga! | p-ʊ́ːrɛ	p-ʊ́ːrɛŋ 
scratch: tʊjʊßâǃ | tʊjʊβâ! 
seed: č˗ɔːrɛ | č-ɔːrɛ 
see: íkaǃ | ana	ika	uɲɛ́k	íka! 
see: uɲɛ́k | ana	ika	uɲɛ́k	íka! 
sew: kandáːrúd̪ɛǃ | kandáːrúd̪ɛ! 
sharp: ŋ˗aːnugɪ́ɲi | ŋ-aːnugɪ́ɲi 
short: ˗amut̪t̪u | -amut̪t̪u 
sister: paámbîŋ 
sit: tiŋgʊd̪ɾɛ̂kǃ | tiŋgʊd̪ɾɛ̂k! 
skin: k˗ɛ́ːd̪û | k-ɛ́ːd̪û	kadu 
sky: k˗ǎy(ɪ́)ri | k-ǎyri	k-ǎyɪ́ri 
sleep: mád̪ɛ | mád̪ɛ 
small: kúlúndɛ | kúlúndɛ 
smoke: n˗ʊ́ːk | n-ʊ́ːk 
smooth: ˗aɲɲik | -aɲɲik 
snake: aːnɛ | aːnɛ	p-ɛnɛ 
snake: p˗ɛnɛ | aːnɛ	p-ɛnɛ 
split: t̪illarurâǃ | t̪illarurâ! 
squeeze: k͂ːŋʷaǃ | k̃ːŋʷa! 
stand: č˗ɔ́ːrʊǃ | č-ɔ́ːrʊ! 
star: č˗ɔːdɔk | Todok	č-ɔːdɔk 
stone: t̪˗ɪ́ŋɔ́ | tiNo	t̪-ɪ́ŋɔ́ 
straight: ˗ad̥d̥iŋ | -ad̥d̥iŋ 
suck: ŋaːyʊǃ | ŋaːyʊ! 
sun: č˗ɪ́ŋgi | TiNg~i	č-ɪ́ŋgi 
swell: č˗ámʊ˗ŋɪ́d̪á 
swim: kaː˗ŋɔ́ŋɔ | kaː-ŋɔ́ŋɔ 
tail: tʊ́ː˗d̪îk | tʊ́ː-d̪îk 
take: ámʷaǃ 
thick: ˗b̥b̥îk | -b̥b̥îk 
think: p˗aná˗d̥ɔd̥ɛː | p-aná-d̥ɔd̥ɛː 
thin: ˗kúlúndɛ | -kúlúndɛ 
thou: aŋɔ́ | aNo	aŋɔ́ 
three: t̪˗at̪t̪ák | t̪-at̪t̪ák	t̯-at̯t̯ák 
throw: tɔ́rɔ(ŋ) | tɔ́rɔ	tɔ́rɔŋ 
tie: ɛːtʊgʊ̂ǃ | ɛːtʊgʊ̂! 
tongue: tʊ́lʊŋɛ̂ | tuluNa	tʊ́lʊŋɛ̂ 
tooth: č˗ɛ́ːɲî | Ta5i	č-ɛ́ːɲî 
tree: p˗ɛːra | para 
turn: wɔːrʊguraǃ 
two: ˗ɛ́ttâ | -ɛ́ttâ	-έttâ	tatta 
vomit: úkkuǃ | úkku! 
walk: ŋ́goǃ | ŋ́go! 
walk: ŋ́gɔǃ | ŋ́go! 
warm: ˗úččû | -úččû 
wash: ɛ́ːmʷaǃ | ɛ́ːmʷa! 
water: ɲ˗ɪ́ | 5i	ɲ-ɪ́ 
we: aːrɪ́k̥ | arik 
wet: ˗it̞t̞îŋ | -it̞t̞îŋ 
what: ɲɛmmɪ́ | ɲɛmmɪ́ 
when: mɪ́nî(ŋ) | mɪ́nî	mɪ́nîŋ 
where: tɪ́ːttɪ́ | tɪ́ːttɪ́ 
white: ˗ɛ́ß̥ß̥î | -ɛ́β̥β̥î 
who: aːpʰɪ́ | aːpʰɪ́ 
wide: ˗ab̥b̥îk | -ab̥b̥îk 
wife: p˗áːrɪ́ | p-áːrɪ́ 
wind: k˗anáŋ | k-anáŋ 
wing: iččɛ | iččɛ	k- 
wing: k˗ | iččɛ	k- 
wipe: kʊd̪ʲɛk̥ǃ | kʊd̪ʲɛk̥! 
woman: p˗ʊrʊk p˗a | p-ʊrʊk p-a 
wood: ɛːdɛ́k 
wood: p˗ 
worm: t˗ʊnǯik | t-ʊnǯik 
year: č˗iːgu | č-iːgu 
yellow: ˗aßʊlla | -aβʊlla 
ash: kɔrɔ́ŋ 
abdomen: č-áːrik 
bigness: -b̥b̥îk 
large: -b̥b̥îk 
breasts: TinT~ik	inǯik 
nail: k-áːdɛdɛ 
talon: k-áːdɛdɛ 
come from: aku	akū!	ájɔ́ 
be dead: p-ɪ́ːŋɔ	piNo 
dead: p-ɪ́ːŋɔ	piNo 
left hand: TibiN	č-ibiŋ 
1 sg.: a5i	aɲɪ́ 
be knowledgeable: banna 
lie down: ɲaŋgɔ́d̪ɛ! 
head louse: tuda 
male: p-ʊrʊk 
much: -íččɔ̂ 
multiple: -íččɔ̂ 
several: -íččɔ̂ 
hill: k-ɔ̂	ko 
title: k-alaŋa	k-alaŋaŋ	kalaNa	kalaNaN 
nighttime: n-ɔ́ŋgɔ́ːda	noNg~oda 
nose: inǯɛ	k-	kinT~a 
adulterous: -állâŋ	tallaN 
single: -állâŋ	tallaN 
that: -állâŋ	tallaN 
the: -állâŋ	tallaN 
unprincipled: -állâŋ	tallaN 
human: p-ʊrʊk̥	puruk 
human being: p-ʊrʊk̥	puruk 
rainy weather: pɛnɛ 
path: kadi 
route: kadi 
hide: k-ɛ́ːd̪û	kadu 
little: kúlúndɛ 
smallness: kúlúndɛ 
rock: tiNo	t̪-ɪ́ŋɔ́ 
2 sg: aNo	aŋɔ́ 
you: aNo	aŋɔ́ 
grind: -ɛ́ttâ	-έttâ	tatta 
go: ŋ́go! 
hot: -úččû 
1 pl. inc.: arik 
we₁: arik 
whiteness: -ɛ́β̥β̥î 
who?: aːpʰɪ́ 
female: p-ʊrʊk p-a 
distant: čɪ́ttaŋ 
dull: -ammî 
serious: -ammî 
close: nándɔ́ŋɔččɔ́ 
ner: nándɔ́ŋɔččɔ́ 
earthworm: t-ʊnǯik 
where?: tɪ́ːttɪ́ 
when?: mɪ́nî	mɪ́nîŋ 
broad: -ab̥b̥îk 
wideness: -ab̥b̥îk 
fat: ŋáak 
principal wife: p-áːrɪ́ 
his mother: nɛːmbɛ̄ 
my mother: nɛːmbɛ̄ 
his father: -bɛ́	abba 
my father: -bɛ́	abba 
woods: tʊ́k 
stick: t̪-ɪ́k 
cord: t̪-ɔːrʊk 
flesh: áːbâ 
grease: ŋáak 
gut: tʊǯʊk 
insides: tʊǯʊk 
intestine: tʊǯʊk 
intestines: tʊǯʊk 
spit: ʊb̥b̥ʊ! 
laughter: ŋaːlwɛ́k! 
cogitate: p-aná-d̥ɔd̥ɛː 
reflect: p-aná-d̥ɔd̥ɛː 
smell: gʊgʊ! 
sniff: gʊgʊ! 
afraid: p-ana-dɛːráŋ 
be afraid: p-ana-dɛːráŋ 
fright: p-ana-dɛːráŋ 
alive: p-aːrá-ná	p-ʊnda 
be alive: p-aːrá-ná	p-ʊnda 
life: p-aːrá-ná	p-ʊnda 
living: p-aːrá-ná	p-ʊnda 
beat: lɪ́wa! 
strike: lɪ́wa! 
hack: kɛɛ́gi 
cut open: t̪illarurâ! 
pierce: tɔkʷa! 
stab: tɔkʷa! 
drop: pa-rɪ́ŋgɔ 
wring: k̃ːŋʷa! 
wash clothes: ɛ́ːmʷa! 
bind: ɛːtʊgʊ̂! 
fasten: ɛːtʊgʊ̂! 
tie up: ɛːtʊgʊ̂! 
enumerate: táŋáːndu 
number: táŋáːndu 
tally: táŋáːndu 
have fun: ɲáːra-nogʊ́tûk 
brook: ʊ́ːrʊ́k 
stream: ʊ́ːrʊ́k 
daylight: tí-ǯɪ́ŋgi	tí-ɪ́ŋgi 
daytime: tí-ǯɪ́ŋgi	tí-ɪ́ŋgi 
evil: -aːgi 
rot: ya-ɲʊ́rʊta 
filthy: aːnu-ŋírí 
soiled: aːnu-ŋírí 
blunt: -umúnda 
damp: -it̞t̞îŋ 
right side: -ariŋ 
