all: č\offa | čʼoffa 
ashes: daːra 
bark: k\ɔlla | kʼɔlla 
belly: gara 
big: gu\d\a | guʼdʼa 
bird: sɨm\bɨrre | sɨmʼbɨrre 
bite: ts\inini | tsʼinini 
black: gur\rača | gurʼrača 
blood: d\iga | Tig	Tiga	diga	dʼiga 
bone: lafe | lafe	lafe7 
breast: harma 
burn: gubbʲ 
claw: k\eːnča | kʼeːnča 
cloud: dumɛnsa 
cold: k\ɛbɛna | kʼɛbɛna 
come: kɔːtʲ | duf	kot	koti	kɔːtⁱ 
die: duʔi | du7	du7i	duʔi 
dog: sare | sare	sare7 
drink: duʔi | Tug	Tugi	dug	duʔi 
dry: goga 
ear: gurra | gura	gurra 
eat: njaːd\u | njaːdʼu 
egg: oko\kan | okoʼkan 
eye: ila 
father: ab\a 
fat (n.): gɛ\bɨnna 
fire: ɨ\bidda | 3bid	3bida	ibida	ɨʼbidda 
fish: k\urtumi | k"urt"umi7	k"urtumi	kʼurtumi 
fly (n.): tiːte 
foot: miːla 
give: kɾɛːnʲ | kɾɛːnⁱ 
good: dɛːnsa 
grass: marra 
hair: rifɛnsa 
hand: harka | hark	harka 
head: mɛtaʔ 
hear: d\agaːy | Tagay	daga	dʼagaːy 
heart: ɔneʔ 
horn: gaːfa | gafa	gaːfa 
I: ana | ana	ani 
kill: ʔɨ\ǯeːsi | ʔɨʼǯeːsi 
knee: ǯɨlba | Tilba	j3lba	ǯɨlba 
know: beːkʲ | beːkⁱ 
leaf: baːla | bala	baːla 
liver: tɨru | t3ru	tiru7	tɨru 
long: d\eːra | dʼeːra 
louse: ɨnǯɨran | 3nj~3ran	inT~irani 
man: nama 
many: hɛː\du | hɛːʼdu 
meat: fɔːnʲ 
moon: ǯiʔa | ǯiʔa 
mountain: gaːra | gara	gaːra 
mouth: aːfan 
name: mɛk\a | mEk"a	mak"a7	mɛkʼa 
neck: mɔrma 
new: haːra | hara	haːra 
night: halkanʲ | halkan	halkani	halkanⁱ 
one: tɔkko | toko	toxo	tɔkko 
other: ˗d\iʻbi 
rain: bo\ka | boʼka 
red: diːma 
road: kara | kara	kara7 
root: hiː\da | hiːʼda 
sand: maːnsa 
say: ǯɛd\e | ǯɛdʼe 
seed: šɛɲi | šɛɲi 
see: laːli | arg	lali	laːli 
sit: taːʔi 
skin: gogaa | goga	goga7	gogaa 
sleep: raːfʲ | raːfⁱ 
small: diː\k\a | diːʼkʼa 
smoke: aːra 
snake: bɔːfa 
stand: d\aː\bad\ʷ 
star: urǯi | urTi7	urji	urǯi 
stone: d\aːka | Taka	daga7	dʼaːka 
sun: adu | adu	adu7 
swim: da\kaːd\ʷ | daʼkaːdʼᵘ 
tail: eːgeʔ 
thin: k\aːlla | kʼaːlla 
this: ˗kaːna | -kaːna 
thou: ati 
three: sɛd\di 
tongue: aːr\ræba | arEba	araba	aːrʼræba 
tooth: ɨlkaːnʲ | 3lkan	3lkani	ilkani	ɨlkaːnⁱ 
tree: muːka | muk	muka	muxa 
two: lama | lam	lama 
walk: deːmʲ 
warm: ɔːʔwa 
water: biː\san | bisan	bisani	biːʼsan 
we: nuː 
wet: ǯiːd\a 
what: maːn 
white: aːdi 
who: ɛːnʷ | ɛːnᵘ 
woman: niːti 
you: issanʲ | ati 
every: čʼoffa 
ash: daːra 
abdomen: gara 
bigness: guʼdʼa 
large: guʼdʼa 
breasts: harma 
nail: kʼeːnča 
talon: kʼeːnča 
come from: duf	kot	koti	kɔːtⁱ 
be dead: du7	du7i	duʔi 
dead: du7	du7i	duʔi 
left hand: hark	harka 
right: hark	harka 
1 sg.: ana	ani 
be knowledgeable: beːkⁱ 
head louse: 3nj~3ran	inT~irani 
male: nama 
much: hɛːʼdu 
multiple: hɛːʼdu 
several: hɛːʼdu 
hill: gara	gaːra 
title: mEk"a	mak"a7	mɛkʼa 
nighttime: halkan	halkani	halkanⁱ 
nose: funani	fuʼnaːni 
adulterous: toko	toxo	tɔkko 
single: toko	toxo	tɔkko 
that: toko	toxo	tɔkko 
the: toko	toxo	tɔkko 
unprincipled: toko	toxo	tɔkko 
human: nama 
human being: nama 
person: nama 
rainy weather: boʼka 
path: kara	kara7 
route: kara	kara7 
hide: goga	goga7	gogaa 
little: diːʼkʼa 
smallness: diːʼkʼa 
rock: Taka	daga7	dʼaːka 
2 sg: ati 
grind: lam	lama 
hot: ɔːʔwa 
1 pl. inc.: nu 
we: nu 
we₁: nu 
whiteness: aːdi 
who?: ɛːnᵘ 
female: niːti 
