all: d\ahɛn | dʼahɛn 
ashes: tɛrd\at | tɛrdʼat 
bark: k\oʔala | kʼoʔala 
belly: karda 
big: ɪkʊt 
bird: hambɪra 
bite: ˗k\anɪn | -kʼanɪn 
black: ɨpor 
blood: d\iːga | Tig	Tiga	dik	dʼiːga 
bone: laftɛ | laft	laftE	laftɛ 
breast: amp\a | amb	amp"a	ampʼa 
burn: ˗dohiyi 
claw: k\ubaya | kʼubaya 
cloud: ura\šɛt | uraʼšɛt 
cold: d\amayta | dʼamayta 
come: ˗d\e | -dʼe	Te	dEy 
die: ˗toy | -toy	tow	toy 
dog: hɛra | hEra	hɛra 
drink: ˗ʔukʲ | -ʔukⁱ	uk	uki 
dry: ɪkok 
ear: laːpɪt | labit	lapit	laːpɪt 
eat: ˗d\amʲ | -dʼamⁱ 
egg: b\ub\a | bʼubʼa 
eye: ɪːnda | ilt	ind~a	ɪːnda 
father: appa 
fat (n.): hayd\a 
fire: a\bita | abit	abita	aʼbita 
fish: k\urtumɛt | k"urt"umEt	k"urtumEt	kʼurtumɛt 
fly (n.): haʔasɪla 
foot: kuː\mač\a | kuːʼmačʼa 
give: ˗day | -day 
good: ɪ\sʊm | ɪʼsʊm 
grass: ʔoːyh 
hair: riyfanta 
hand: harka | hark	harka 
head: mɛš | mɛš 
hear: ˗d\agay | -dʼagay	Tagay	dagay 
heart: mut\ura | mutʼura 
horn: kasa | kas	kasa 
I: ana | an	ana	anto	antot 
kill: ˗ygɛj | -ygɛj 
know: ˗šaːgʲ | -šaːgⁱ 
leaf: lapita | labit	lapit	lapita 
liver: šɪra | Sira	šɪra 
long: ɪč\ɪf | ɪčʼɪf 
louse: ikirɛt | ikirEt 
man: nama | nam	nama 
many: hɛ\lɛk | hɛʼlɛk 
meat: soha 
moon: leʔa 
mountain: wutɛt | wudEt	wutEt	wutɛt 
mouth: kapa 
name: maha | mah	maha 
neck: koʔot 
new: awšiːt | awSit	awšiːt 
night: awɛd\at | awETat	awad	awɛdʼat 
one: šoko | Sok	Soko	shokku	šoko 
other: hɛpɪl 
rain: roba 
red: ɛrroma 
road: pana 
root: hɪtina 
sand: raːkaka 
say: ˗kɪd\i | -kɪdʼi 
see: ˗akʲ | -akⁱ	ak	aki 
seed: hoːta 
sit: ˗lad\i | -ladʼi 
skin: k\ɔla | k"ol	k"ola	kʼɔla 
sleep: ˗pɛʔad\i | -pɛʔadʼi 
small: ˗tɪ\naʔ | -tɪʼnaʔ 
smoke: k\aya | kʼaya 
snake: maːka 
stand: ˗li 
star: hɪska | hiska	hɪska 
stone: d\aka | Taka	daga	dʼaka 
sun: lɛša | lES	lESa	laS	lɛša 
swim: ˗taki | -taki 
tail: siːta 
thin: ɪ\k\ahɪna | ɪʼkʼahɪna 
this: sɛːti 
thou: atɪ | at	atE	ati	atɪ 
three: hal\bat 
tongue: arraba | araba	arap	arraba 
tooth: ilit | ilh~it	ilit 
tree: k\oraya | k"or	k"oraya 
two: lake | lak	lakE	lake	lakki 
walk: ˗ani 
warm: otɔt 
water: haka | hak	hak"	haka 
we: ɪnʷ | in	ino	inu 
wet: č\abɛt 
what: maːna 
white: (i)pohkid\ | ipohkidʼ	pohkidʼ 
who: aːynu 
woman: ɪskɔt 
you: ɪnna | at	atE	ati	atɪ 
every: dʼahɛn 
ash: tɛrdʼat 
abdomen: karda 
bigness: ɪkʊt 
large: ɪkʊt 
breasts: amb	amp"a	ampʼa 
nail: kʼubaya 
talon: kʼubaya 
come from: -dʼe	Te	dEy 
be dead: -toy	tow	toy 
dead: -toy	tow	toy 
left hand: hark	harka 
right: hark	harka 
1 sg.: an	ana	anto	antot 
knee: kilp 
be knowledgeable: -šaːgⁱ 
head louse: ikirEt 
male: nama 
much: hɛʼlɛk 
multiple: hɛʼlɛk 
several: hɛʼlɛk 
hill: wudEt	wutEt	wutɛt 
title: mah	maha 
nighttime: awETat	awad	awɛdʼat 
nose: sina 
adulterous: Sok	Soko	shokku	šoko 
single: Sok	Soko	shokku	šoko 
that: Sok	Soko	shokku	šoko 
the: Sok	Soko	shokku	šoko 
unprincipled: Sok	Soko	shokku	šoko 
human: nam	nama 
human being: nam	nama 
person: nam	nama 
rainy weather: roba 
path: pana 
route: pana 
hide: k"ol	k"ola	kʼɔla 
little: -tɪʼnaʔ 
smallness: -tɪʼnaʔ 
rock: Taka	daga	dʼaka 
2 sg: at	atE	ati	atɪ 
grind: lak	lakE	lake	lakki 
hot: otɔt 
1 pl. inc.: in	ino	inu 
we₁: in	ino	inu 
whiteness: ipohkidʼ	pohkidʼ 
who?: aːynu 
female: ɪskɔt 
