all: temεbε | temebe 
and: εru | ner[e] 
animal: ɸeiǰε 
ashes: tuguanə | tugwane 
back: фague | tariro- 
bad: kabia 
bark: εritə 
belly: ɸeta | fta- 
bird: man | ma-nə 
bite: nəgɔrə | -mə|gor 
black: garəmutənə | gr|mutəne 
blood: waməsə | wa-mese	wam3s3 
blow: guɸə ɸena | nufə 
bone: rurə | -rure	rur3 
breast: susə | -susu	sus3 
breathe: sague | -me|sagwe 
burn: somətə 
child: mɔ 
cloud: taĵe | taye 
cold: rid ən ə | ridənə 
come: ʔa-ma | -ma	ma 
correct: ɸeitu 
count: neɸə | -efə 
cut: mətiɸənə | -ma|totə 
die: nəmatə | -matə	n3mat3 
dig: [nəgarə] | mə|garə 
dirty: nəserə | fise 
dog: ɸunə | funə	pun3 
drink: ninə | -gin[e]	nin3 
dry: mamua | məma 
dull: kumə | riməne | pumə 
dust: tiguam | ɔbə 
ear: təgəra | -tegra-	t3g3ra 
earth: wirom 
egg: təru 
empty: nati 
eye: matie | -mətie-	matie 
fall: topa | -mə|titi 
far: nεrɔ | nero 
father: anǰe | die 
fat (n.): məterə 
fear: namεtatə | -mta-t|e 
few: mεtətu 
fingernail: kuku 
fire: ɸeηa | fina	pena 
fish: somə | som3	some 
five: rεɸidə | p̵řandɛ-p̵ɪndɛ 
float: nabɔrə 
flower: ɸu | kaka 
flow: nəфəфɔ | -nevovo 
fly (v.): manə sora 
fog: wεnɔbə | wenobə 
forest: witu 
four: gegəte | gegite	ŋge-ŋgɛtɛ 
frog: wagari 
fruit: ɸo | fo	fu 
full: nəɸonə | n3pon3 
give: nane 
good: derə | dire 
grass: samuinə | samwine	sisine 
green: məmatə 
guts: ɸəta nətatu | -fta- teni 
hair: ragunə φaru | rogwin fru 
hand: ɸəra | fra-	p3ra 
head: rəgunə | rogwine 
hear: naɸarogərə | -ba|nogre-	naparog3r3 
heart: Puŋ 
heavy: remənə | riməne 
he: i 
hit:  matəbε | metebe 
how: nano | bənaneno 
hunt: nəɸanaɸətə | mə|tətanfe 
husband: a məran | mərane 
I: ǰa | ia	ja 
in: ganə | gane 
kill: na-ɸunə | -bunə 
knee: wiɸu | wipu 
lake: tāma | sar were 
large: nabadə | nabade 
laugh: nabariɸə | -berrife 
leaf: rɔ | [e]ro	ro 
left: batƏ | trire 
leg: ɸa 
lie: nen | gin gerevivare- 
live: du nami wεnumə | -rega 
liver: bərəɸɔtə | -te	b3r3pot3 
long: mərərɔ | mərəro 
louse: utə | ut3	utə 
man: maranə | matu 
many: mogə 
meat: ǰe | fie 
moon: seba 
mother: adεnə | d|ena 
mountain: tarɔ | taro 
mouth: gānə | -rimeta- 
name: no | no	nu 
narrow: sotə | frifre-te 
near: nəbabərə | nəbəbabəre 
neck: dərəbonə | dərbunə 
new: bunatə | bunat3	bunate 
night: gisiε | gisiE	gisie	gənite 
nose: wεgurə | -wegurə	wEgur3 
old:   radi 
one: εso | Eso	eso	ɛsu 
person: matu 
play: nεraduεnə 
pull: gesə 
push: nəфəsisə 
rain: siεmə | sie-mə 
red: karəruεrə | waməse 
right: tu | fra-	p3ra 
river: nigətə 
road: radэni nabadэ | rad3ni	radeni 
root: kakɔakərə | kwakare	warkrikre 
rope: wara 
rotten: gumerə | numi-rə 
round: ɸuturomə 
rub: nisərə 
salt: tərirə | te 
sand: inəñεфu | inneñevo 
say: nəɸiεrə | -biere | inneñevo 
sea: wεrəɸunə | were fune 
seed: ɸrsubə 
sew: raini | -mutə 
sharp: rəɸo ǰε kərerə | matadane 
short: фutə | kəfutə 
sing: sisə 
sit: nəmətorə | matorə 
skin: ritə | -rite	rit3 
sky: ragətə 
sleep: neenə | -gi-ne 
small: kɔsi | kosi 
smell: səgəɸɔ | -me|səgəfo 
smoke: bɔbə 
smooth: səruidənə 
snake: sawatə | yaka 
some: εsεso 
spit: daɸey | -beni	-mə|tefe 
split: məragəte | -mə|ragete 
stab: mətəro | mə|tarə 
stand: nəmarirə | mə|rire 
star: torə | tor3	turə 
stick: tonə 
suck: ninə susə | -bəsəbuse 
sun: ɸimətiє | pim3tiE 
tail: su 
they: irə | ire 
thick: ɸata torə | sarfə 
thin: bəniɸənə | bə|nənifə|ne 
think: nəɸεtiɸənə nəɸərərɔ rə | -vederbono 
thou: ɔ 
thou: ε 
three: torə | torə	tu-řu 
throw: məti | -mə|ti	-mə|tru 
tie: nəbεrə | mə|remte 
tongue: mamaǰe | -mamaye-	mamaje 
tree: ɛ 
turn: magarфarə 
two: riɸo | rifo	ripo	řip̵u 
vomit: nεɯi | mə|rue 
warm: winə ɸəmani | wi-nə 
wet: səruərə | kəmusə	səroere 
what: ña | fera 
when: gonə ña | mese 
which: фadə  nεnɔ 
white: baɸutэ | bəvutə 
who: gata 
why: nanɔ 
wide: фariфərə | frifre 
wife: a uagə | sote 
wind: nəɸə | nofə 
wing: manə ɸariɸərə | -frivre 
woman: sɔtə | bevine 
worm: kʷaytuba | seye 
wrong: səru 
year: taun εso 
yellow:  taɸə | tafə 
every: temebe 
ash: tugwane 
abdomen: fta- 
big: nabade 
bigness: nabade 
breasts: -susu	sus3 
come from: -ma	ma 
be dead: -matə	n3mat3 
dead: -matə	n3mat3 
eat: -ga 
feather: fou 
fly: -su-re 
fly v.: -su-re 
left hand: fra-	p3ra 
1 sg.: ia	ja 
be knowledgeable: -rarune 
know: -rarune 
lie down: gin gerevivare- 
head louse: ut3	utə 
male: məra-ne 
hill: taro 
title: no	nu 
nighttime: gisiE	gisie	gənite 
adulterous: Eso	eso	ɛsu 
single: Eso	eso	ɛsu 
that: mavi 
the: Eso	eso	ɛsu 
unprincipled: Eso	eso	ɛsu 
human: matu 
human being: matu 
rainy weather: sie-mə 
path: rad3ni	radeni 
route: rad3ni	radeni 
see: -məsi	si 
hide: -rite	rit3 
little: kosi 
smallness: kosi 
smoke: ɔbə 
rock: kami 
stone: kami 
swim: -kaka 
this: not|ini 
tooth: -refo-	r3pu 
grind: rifo	ripo	řip̵u 
go: -fanə 
walk: -fanə 
hot: wi-nə 
water: wEr3	were 
1 pl. inc.: am	am3	it	it3 
we: am	am3	it	it3 
we₁: am	am3	it	it3 
whiteness: bəvutə 
who?: gata 
female: bevine 
distant: nero 
serious: riməne 
close: nəbəbabəre 
ner: nəbəbabəre 
earthworm: seye 
year: taun 
2 pl.: e[ro] 
ye: e[ro] 
you: e[ro] 
you all: e[ro] 
3 pl.: ire 
where: ne|nino 
where?: ne|nino 
when?: mese 
how?: bənaneno 
other: nenote 
broad: frifre 
wideness: frifre 
fat: sarfə 
principal wife: sote 
his mother: d|ena 
my mother: d|ena 
his father: die 
my father: die 
woods: witu 
cord: wara 
flesh: fie 
gut: -fta- teni 
insides: -fta- teni 
intestine: -fta- teni 
intestines: -fta- teni 
breath: -me|sagwe 
laughter: -berrife 
cogitate: -vederbono 
reflect: -vederbono 
sniff: -me|səgəfo 
afraid: -mta-t|e 
be afraid: -mta-t|e 
fright: -mta-t|e 
alive: -rega 
be alive: -rega 
life: -rega 
living: -rega 
beat: metebe 
strike: metebe 
hack: -ma|totə 
cut open: -mə|ragete 
pierce: mə|tarə 
scratch: -mesegigere	-murə 
drop: -mə|titi 
grasp: -muda 
hold: -muda 
hold in arm: -muda 
squeeze: -muvrə 
wring: -muvrə 
bind: mə|remte 
fasten: mə|remte 
tie up: mə|remte 
enumerate: -efə 
number: -efə 
tally: -efə 
ocean: were fune 
evil: kabia 
rot: numi-rə 
filthy: fise 
soiled: fise 
blunt: pumə 
damp: kəmusə	səroere 
right side: tu 
at: ne- 
inside: gane 
