all: kabeh | kabeh	sedanten	sedaya 
all: sabən | kabeh	sedanten	sedaya 
and: lan | kalawan	kaliyan	lan 
animal: [sato] | kewan	sato 
ashes: awu 
back: gəgər | geger	gěgěr	peŋker 
bad: ɔlɔ | awon	dahat	elek 
bark: klikɔ 
because: awit 
belly: wətəŋ | padaran	padhaharan	weteng	weteŋ	wětěng 
big: gedhe | a-gung	a-göng	a-gěng	ageng	aqeŋ	gede	gedhe	gung	göng	gěng 
bird: manuʔ | manuk	peksi 
bite: ñakɔt (čakэt) | cokot	gugut	krět	ñokot 
black: irəŋ | cemeŋ	hirěng	ireŋ	irěng 
blood: gətih | getih	rah	râh 
blow: sumilir | sumilir	tyup 
bone: baluŋ | balung	baluŋ	tahulan 
breast: susu | payudara	susu 
breathe: ambək-an | ambegan	amběgan 
burn: m-bakar | mbesem	tunu	ŋoboŋ 
child: bočah | anak	lare 
cloud: mendhung | mega	megha 
cloud: [mеgɔ] | mega	megha 
cold: aḍəm | a-tis	asrep	aḍem	ma-tis	tis 
come: təkɔ | dateŋ	para	rawuh	teka 
correct: bэnэr 
count: ñăčah(čačah) | hitung	ŋetaŋ	ŋgtuŋ 
cut: nugəl (tugəl) | kethok	nugel	tětěk 
die: mati (pati) | mati	pati	seda 
dig: n-duduʔ | gali	nḍuḍuk 
dirty: rəgət | kotor	reget	rigěd 
dog: asu | asu	segawon	seqawon 
drink: ŋ-ombe | inum	ombe	ŋombe	ŋunjuk 
dry: gariŋ | a-sat	akiŋ	gariŋ	sat 
dull: kəṭul | a-bot	a-bwat	abot	awrat	bot	bwat | keṭul	kět.ul 
dust: bləduk | awu	bledug 
ear: kupiŋ | kuping	kupiŋ	talinga	talingan	taliŋan 
earth: [bumi] 
eat: mangan | dahar	mangan	maŋan	pangan	umangan 
egg: ənḍɔk | antiga	endhog	enḍog	tigan 
empty: kɔtpŋ 
eye: mɔtɔ | mata	mripat	netra	soca 
fall: -m{ш}ei | dawah	dhawah	tiba 
far: adɔh | adoh	doh	ma-doh	tebih 
father: bapaʔ | bapa	bapak	rama	râma	yayah 
fat (n.): gaǰih 
fear: wədi | ajirih	ma-takut	wedi 
feather: wulu 
few: sitiʔ | sekedhik	sithik 
fingernail: ǰεǰum-o | kuku 
fingernail: kuku 
fire: [gəni] | apuy	geni	latu 
fish: iwaʔ | iwak	ulam 
five: limɔ | gangsal	lima 
float: ŋambaŋ (kambaŋ) 
flower: kəmbaŋ | kembang	kembaŋ	sekar	wunga 
flow: mill (m-ili) | hili	hilir	ili	ilir	mili 
fly (v.): m-abur 
fog: pədut | kabut	peḍut 
foot: sikil | samparan	sikil	suku 
forest: alas | alas	wana 
four: papat | papat	pat	sekawan 
frog: kɔdɔʔ 
fruit: wɔh | woh	woh-wohan	wwah 
full: kəbaʔ 
give: mεnεhi (wεnεh) | atur	paring	weneh 
good: apiʔ | apik	apik (Mod. Jav.)	sae 
grass: sukət | rumput	suket	sukět 
green: iǰo | hijo	ijem	ijo	wilis 
guts: ǰəro-an | usus 
hair: rambut | rambut	rikma 
hand: taŋan | asta	tangan	taŋan 
head: əndas | endhas	hulu	mustaka	sirah 
head: sirah | endhas	hulu	mustaka	sirah 
hear: ŋruŋu (kruŋu) | d.ěngěr	kruŋu	mireŋ	rungu	rěngö 
heart: ǰantuŋ 
heavy: abɔt | a-bot	a-bwat	abot	awrat	bot	bwat 
he: ḍεwεʔ-e | dheweke	panjenenganipun 
hit: ŋ-antəm | amupuh	nutuk	p-in-upuh	puh	pupuh 
horn: suŋu | sungu 
how: kəprie | kados pundi	kepriye	mapa	piye	pripun	ring apa 
hunt: m-buru | buru	mbebeḍag 
husband: laki | bojo	garwa	laki	semah 
I: aku | aku	dalem	kami	kula	nghulun	ngwang 
ice: [εs] 
if: yɛn | menawi	nek	yan 
in: (ñ-)ǰəro | ana njero	dalěm	wouten ŋlebet 
kill: matε-ni | amati	mateni	pati	ñedani 
knee: ḍəŋkul | dhengkul 
know: wəruh | maŋertos	mudheng	ngerti	wruh	ŋerti 
lake: [tlɔgə] | ranu	tlaga 
large: gəde | a-gung	a-göng	a-gěng	ageng	aqeŋ	gede	gedhe	gung	göng	gěng 
laugh: ŋ-guyu | g-um-uyu	guyu	qumujeŋ	ŋguyu 
leaf: gɔḍɔŋ | godhong	godoŋ	ron 
left: kiwυ | kering	kiwa 
leg: sikil | samparan	sikil	suku 
lie: turэn | lěmah	sarean	turon | ngapusi 
liver: ati | ati	manah 
live: urip | hurip	ma-hurip	qesaŋ	urip 
long: dɔwɔ | dawa	dawâ	panjang	panjaŋ 
louse: tumɔ | tuma 
man: wɔŋ lanaŋ | manungsa	tiyaŋ	uwoŋ	wong	wwang 
many: akεh | akeh	kathah 
meat: dagiŋ | daging	isi	ulam	ḍagiŋ 
moon: bulan | mbulan	surya	wulan 
mother: ibu | ibu	ina	rena 
mountain: gunuŋ 
mouth: čaŋkəm | cangkem	caŋkem	tutuk 
name: ǰəηəŋ | asma	jeneŋ	nama	ngaran 
narrow: səmpit | apit	ciyut	hapit	sempit	sesak 
near: čədaʔ | celak	ceḍak	cělak 
neck: gulu | gulu	gulû	jaŋqa	těnggěk 
new: añar | añar	eŋqal	hañar 
night: bэŋi | beŋi	dalu	wěngi 
nose: iruŋ | grana	irung	iruŋ 
not: ora, dudu | dudu	ora 
old: tuɔ 
one: siǰi | sa-	setunggal	setuŋŋal	siji	tunggal 
person: wɔŋ | manungsa	tiyaŋ	uwoŋ	wong	wwang 
play: main-an 
pull: nariʔ (tariʔ) | tarik 
push: ñuruŋ (suruŋ) | surung 
rain: udan | jawah	udan 
red: abaŋ | abaŋ	abrit	mirah 
right: təŋən | asta	tangan	taŋan | kanan	tengen	teŋen 
river: kali 
road: dalan | dalan	margi 
root: ɔyɔt | akar	oyod	oyot 
rope: tali | tali	taŋsul 
rotten: bɔsɔʔ | mambet	mambu	wûk 
round: bundər 
rub: ŋ-gɔsɔʔ 
salt: uyah | sarem	uyah	wuyah 
sand: wəḍI | pasir	weḍi	ěni 
say: kɔnɔḍ | kanda	tutur	ŋendika | pasir	weḍi	ěni 
sea: [səgɔrɔ] | segara	seqanten	tasik 
seed: winih | wiji 
see: ndeleng | deleng	l-um-ihat	lihat	mirsani	nonton 
see: ndelok | deleng	l-um-ihat	lihat	mirsani	nonton 
sew: ñ-ǰait | dondom	jahit	njahit 
sharp: landəp | lan.d.ěp	lanḍep 
short: čəndaʔ | celak	cendhek	cenḍak	cěn.d.ak 
sing: nəmbaŋ (təmbaŋ) 
sit: luŋguh | lengah	leŋqah	loŋguh	lungguh	pinarak 
skin: kulit 
sky: laŋit | langit	laŋit 
sleep: turu | sare	turu	turû 
small: čiliʔ | alit	cilik	d.ěmit 
smell: ŋ-ambu | ambu	ŋambu	ŋqanda 
smoke: kəbul | asep	keluk	kukus 
smooth: alus 
snake: ulɔ | sawer	ula	ulâ 
snow: [salǰu] 
some: saʔ-wətɔrɔ 
spit: idu | idu	mang-idu 
split: m-bəlah | pilah	ñyigar 
stab: tusuʔ | nujes	tusuk 
stand: ŋ-adək | ad.ěg	jumeneng	jumeneŋ	ngadek	ŋadek 
star: lintaŋ | kartika	lintaŋ	wintang 
stick: təkən | pang	paŋ 
stone: watu | sela	watu 
suck: ñəḍɔt (səḍot) | sěsěp	ñerot	ŋisep 
sun: srəŋeŋe 
swim: nglangi | langhuy	nglangi	ŋlaŋi 
tail: buntut | buntut	ikû 
that: iku, kuwi | ika	iku	kuwi	menika	punika	puniku | sa-	setunggal	setuŋŋal	siji	tunggal 
thick: kandəl | kandel	kanděl 
think: mikir ([pikir]) ŋ-gagas | hid.ěp	meŋqalih	mikir 
thin: tipis 
this: iki | iki	menika	puniki 
thou: koe | kamu	kita	ko	kowe	ngko	panjenengan	panjeneŋan	sampeyan 
thou: koe kabεh | kamu	kita	ko	kowe	ngko	panjenengan	panjeneŋan	sampeyan 
three: təlu | telu	tiga	tělu 
throw: m-balaŋ | balang	habalang	mbucal	sawat	ŋguwaŋ 
tie: nalεni | ikět	naleni	naŋsuli	um-ikět 
tongue: ilat | ilat	lidah 
tooth: untu | huntu	untu	waja	waos 
tree: wit 
turn: m-balik 
two: loro | kalih	loro	ro	rwa 
vomit: mutah (wutah) | mutah	umutah	wutah 
walk: m-laku | laku	lampah	mlaku	mlampah 
warm: panas | a-panas	benfer	ma-panas	panas 
water: banyu | bañu	toya	wway	wwe 
we: awake dhewe | aku kabeh	awake dhewe	kami	kawula sami	kita sedaya 
wet: tələs | basah	teles	wasěh 
what: ɔpɔ | apa	mapa	menapa	punapa 
when: kapan | benjaŋ menapa	kapan 
which: əndi 
white: putih | petak	putih	pět.ak 
who: sɔpɔ | sapa	sinten	syapa 
why: ŋ-ɔpɔ 
wide: ɔmbɔ | amba	jembar	lwâ	wiyar 
wife: bini | bini	bojo	garwa	semah	wini 
wind: aŋin | angin	aŋin	barat	hangin 
wing: suiwi | elar	kěpěk	suwiwi	swiwi 
woman: wɔŋ wadɔn | estri	wadon	wadwan	wedok 
worm: čačiŋ | cacing	caciŋ	uler 
wrong: luput 
year: taun | tahun 
yellow: kuniŋ | jene	kuning	kuniŋ 
every: kabeh	sedanten	sedaya 
ash: awu 
abdomen: padaran	padhaharan	weteng	weteŋ	wětěng 
bigness: a-gung	a-göng	a-gěng	ageng	aqeŋ	gede	gedhe	gung	göng	gěng 
breasts: payudara	susu 
burn tr.: mbesem	tunu	ŋoboŋ 
come from: dateŋ	para	rawuh	teka 
be dead: mati	pati	seda 
dead: mati	pati	seda 
fly: iběr	mabur 
fly v.: iběr	mabur 
left hand: asta	tangan	taŋan 
1 sg.: aku	dalem	kami	kula	nghulun	ngwang 
be knowledgeable: maŋertos	mudheng	ngerti	wruh	ŋerti 
lie down: lěmah	sarean	turon 
head louse: tuma 
male: jaler	jalu	lanang	lanaŋ 
much: akeh	kathah 
multiple: akeh	kathah 
several: akeh	kathah 
title: asma	jeneŋ	nama	ngaran 
nighttime: beŋi	dalu	wěngi 
adulterous: sa-	setunggal	setuŋŋal	siji	tunggal 
single: sa-	setunggal	setuŋŋal	siji	tunggal 
the: sa-	setunggal	setuŋŋal	siji	tunggal 
unprincipled: sa-	setunggal	setuŋŋal	siji	tunggal 
human: manungsa	tiyaŋ	uwoŋ	wong	wwang 
human being: manungsa	tiyaŋ	uwoŋ	wong	wwang 
rainy weather: jawah	udan 
path: dalan	margi 
route: dalan	margi 
hide: kulit 
little: alit	cilik	d.ěmit 
smallness: alit	cilik	d.ěmit 
rock: sela	watu 
2 sg: kamu	kita	ko	kowe	ngko	panjenengan	panjeneŋan	sampeyan 
you: kamu	kita	ko	kowe	ngko	panjenengan	panjeneŋan	sampeyan 
grind: kalih	loro	ro	rwa 
go: laku	lampah	mlaku	mlampah 
hot: a-panas	benfer	ma-panas	panas 
1 pl. inc.: aku kabeh	awake dhewe	kami	kawula sami	kita sedaya 
we₁: aku kabeh	awake dhewe	kami	kawula sami	kita sedaya 
whiteness: petak	putih	pět.ak 
who?: sapa	sinten	syapa 
female: estri	wadon	wadwan	wedok 
distant: adoh	doh	ma-doh	tebih 
serious: a-bot	a-bwat	abot	awrat	bot	bwat 
close: celak	ceḍak	cělak 
ner: celak	ceḍak	cělak 
earthworm: cacing	caciŋ	uler 
3 sg.: dheweke	panjenenganipun 
she: dheweke	panjenenganipun 
2 pl.: kamu	kita	kowe kabeh	panjeŋeŋan sami 
ye: kamu	kita	kowe kabeh	panjeŋeŋan sami 
you all: kamu	kita	kowe kabeh	panjeŋeŋan sami 
3 pl.: deweke kabeh	dheweke kabeh	sira 
they: deweke kabeh	dheweke kabeh	sira 
here: kene	riki 
there: kana	kono	rika	riku 
where: ana ŋendi	endi	ndi	pundi	wouten pundi 
where?: ana ŋendi	endi	ndi	pundi	wouten pundi 
when?: benjaŋ menapa	kapan 
how?: kados pundi	kepriye	mapa	piye	pripun	ring apa 
other: benten	liya	lyan	sanes	seje 
broad: amba	jembar	lwâ	wiyar 
wideness: amba	jembar	lwâ	wiyar 
fat: gajih	miñak	wuduk 
principal wife: bini	bojo	garwa	semah	wini 
his mother: ibu	ina	rena 
my mother: ibu	ina	rena 
his father: bapa	bapak	rama	râma	yayah 
my father: bapa	bapak	rama	râma	yayah 
woods: alas	wana 
branch: pang	paŋ 
cord: tali	taŋsul 
flesh: daging	isi	ulam	ḍagiŋ 
grease: gajih	miñak	wuduk 
claw: kuku 
nail: kuku 
arm: asta	tangan 
gut: usus 
insides: usus 
intestine: usus 
intestines: usus 
breath: ambegan	amběgan 
laughter: g-um-uyu	guyu	qumujeŋ	ŋguyu 
cogitate: hid.ěp	meŋqalih	mikir 
reflect: hid.ěp	meŋqalih	mikir 
sniff: ambu	ŋambu	ŋqanda 
afraid: ajirih	ma-takut	wedi 
be afraid: ajirih	ma-takut	wedi 
fright: ajirih	ma-takut	wedi 
alive: hurip	ma-hurip	qesaŋ	urip 
be alive: hurip	ma-hurip	qesaŋ	urip 
life: hurip	ma-hurip	qesaŋ	urip 
living: hurip	ma-hurip	qesaŋ	urip 
beat: amupuh	nutuk	p-in-upuh	puh	pupuh 
strike: amupuh	nutuk	p-in-upuh	puh	pupuh 
hack: kethok	nugel	tětěk 
cut open: pilah	ñyigar 
pierce: nujes	tusuk 
scratch: kukur	ŋukur 
tell lies: ngapusi 
drop: dawah	dhawah	tiba 
grasp: asta	cekel	cepeng	gěgěm	ñekel	ŋasta 
hold: asta	cekel	cepeng	gěgěm	ñekel	ŋasta 
hold in arm: asta	cekel	cepeng	gěgěm	ñekel	ŋasta 
squeeze: meres	pěrěs 
wring: meres	pěrěs 
wash: umbah 
wash clothes: umbah 
shove: surung 
bind: ikět	naleni	naŋsuli	um-ikět 
fasten: ikět	naleni	naŋsuli	um-ikět 
tie up: ikět	naleni	naŋsuli	um-ikět 
enumerate: hitung	ŋetaŋ	ŋgtuŋ 
number: hitung	ŋetaŋ	ŋgtuŋ 
tally: hitung	ŋetaŋ	ŋgtuŋ 
ocean: segara	seqanten	tasik 
evil: awon	dahat	elek 
rot: mambet	mambu	wûk 
filthy: kotor	reget	rigěd 
soiled: kotor	reget	rigěd 
blunt: keṭul	kět.ul 
damp: basah	teles	wasěh 
right side: kanan	tengen	teŋen 
at: ana	i	ri	wouten 
inside: ana njero	dalěm	wouten ŋlebet 
