all: has t3pwes	ph~3	pʰɨ 
every: has t3pwes	ph~3	pʰɨ 
ash: p3ph~3h	ʔɨpʰˈɨ 
ashes: p3ph~3h	ʔɨpʰˈɨ 
bark: lototh~	lotˈotʰ 
abdomen: kol	ŋ=kol 
belly: kol	ŋ=kol 
big: p3ne	pɨnˈe 
bigness: p3ne	pɨnˈe 
large: p3ne	pɨnˈe 
bird: cipyaya	cipyˈaya 
black: te 
blood: na=ʔˈas	nas 
bone: n=kʰˈele	nkh~ele 
breast: na=hˈas sˈuna	ncoc" 
breasts: na=hˈas sˈuna	ncoc" 
burn: ʔyɨm 
burn tr.: ʔyɨm 
claw: m=pepʰ	mpeph~ 
nail: m=pepʰ	mpeph~ 
talon: m=pepʰ	mpeph~ 
cloud: mol 
cold: ch~ohose	cʰohˈose 
come: kuwis	kuwˈi-s 
come from: kuwis	kuwˈi-s 
be dead: ni p37i	ni pɨʔˈi 
dead: ni p37i	ni pɨʔˈi 
die: ni p37i	ni pɨʔˈi 
dog: ch~iyo	cʰiyˈo 
drink: m3s	mɨʔˈɨ-s 
dry: c"ic"e	ph~a	pʰa 
ear: m=pʰacʼ	mph~ac" 
earth: ama	ʔamˈa 
ground: ama	ʔamˈa 
land: ama	ʔamˈa 
soil: ama	ʔamˈa 
eat: hipis	la	lya	ly~a 
egg: pehey	pehˈey 
eye: hun	na=n	nan 
fat: pan 
fat n.: pan 
grease: pan 
lubricant: pan 
oil: pan 
feather: ph~3s3s	pom	pʰɨsˈɨs 
fire: awa	ʔˈawa 
fish: kh~ul	kʰul 
fly: hum 
fly v.: hum 
foot: n=cʰam	nch~am 
full: pit"	pitʼ 
give: ya	ʔya 
good: 3kh~	3s3s	ʔɨsˈɨs 
green: ch~u	cʰu 
hair: n=cʼil	nc"il 
hand: na=mˈas	namas 
left hand: na=mˈas	namas 
right: na=mˈas	namas 
head: n=ay pʰɨkʰ	nay ph~3kh~ 
hear: ph~okas	pʰok-ˈas 
heart: na=hˈas	nahas 
horn: ch~3eme	cʰɨ̯ˈeme	cʰˈeme 
1 sg.: naph~	napʰ 
I: naph~	napʰ 
kill: y3nan	ʔyɨnˈan	ʔɨnˈan 
knee: n=tikʼ	ntik" 
be knowledgeable: sele	selˈe 
know: sele	selˈe 
leaf: lo 
lie: p3s	p3t	pɨʔ-ˈɨs 
lie down: p3s	p3t	pɨʔ-ˈɨs 
liver: Nkom	ŋ=kom 
long: kampa	kˈampa 
head louse: t3t	tɨtʼ 
louse: t3t	tɨtʼ 
male: yom 
man: tol	yom 
many: p3l3kh~	pɨlˈɨkʰ 
much: p3l3kh~	pɨlˈɨkʰ 
multiple: p3l3kh~	pɨlˈɨkʰ 
several: p3l3kh~	pɨlˈɨkʰ 
flesh: pis 
meat: pis 
moon: m3m3y	mɨmˈɨy 
hill: hok"	hokʼ 
mountain: hok"	hokʼ 
mouth: n=lˈala	nlala 
name: n=la	nla 
title: n=la	nla 
neck: ne=mˈen	nemen	nulup"ah 
new: sy~asa	syˈasa 
night: p3ste	pˈɨste 
nighttime: p3ste	pˈɨste 
nose: ne=mˈikʰ	nemikh~ 
not: ma	tulukh~ 
adulterous: pani	ph~ani	pʰanˈi 
one: pani	ph~ani	pʰanˈi 
single: pani	ph~ani	pʰanˈi 
that: nempe	nenem	nenˈem 
the: pani	ph~ani	pʰanˈi 
unprincipled: pani	ph~ani	pʰanˈi 
human: tol	yom 
human being: tol	yom 
person: tol	yom 
rain: h3w3	hɨwˈɨ 
rainy weather: h3w3	hɨwˈɨ 
red: he 
path: h3m3kh~	hɨmˈɨkʰ 
road: h3m3kh~	hɨmˈɨkʰ 
route: h3m3kh~	hɨmˈɨkʰ 
root: c"3il	cʼil	cʼɨ̯il 
sand: sus 
say: kusku	βelˈe 
see: nukʰ	nyukʰ	ny~ukh~ 
seed: setel	setˈel 
sit: os	ʔo-s 
hide: m=pʼɨy	polok 
skin: m=pʼɨy	polok 
sleep: ha	hya	hy~a 
little: ch~ikh~	cʰikʰ	in la7 way 
small: ch~ikh~	cʰikʰ	in la7 way 
smallness: ch~ikh~	cʰikʰ	in la7 way 
smoke: mus 
stand: hy~3ns3	hɨ-s 
star: ph~ul	pʰul 
rock: pe 
stone: pe 
sun: kokoy	loc"akh~	locʼˈakʰ 
tail: sok"	sokʼ 
this: cikin mo7o	nempe	nenem	nina	ninˈa 
2 sg: hiph~	hipʰ	my~a	nun 
thou: hiph~	hipʰ	my~a	nun 
you: hiph~	hipʰ	my~a	nun 
tongue: m=pelˈam	mpelam 
tooth: m=βis	mvis 
tree: yo 
grind: mat"e	mata	mˈa-tʼe 
two: mat"e	mata	mˈa-tʼe 
go: hum	winis 
walk: hum	winis 
hot: ʔyˈawa	ʔˈawa 
warm: ʔyˈawa	ʔˈawa 
water: 3s3	ʔɨsˈɨ 
1 pl. inc.: kuph~	kupʰ 
we: kuph~	kupʰ 
we₁: kuph~	kupʰ 
what: ch~an	cʰan	oyn 
white: ph~e	pʰe 
whiteness: ph~e	pʰe 
who: ph~akh~	pʰakʰ 
who?: ph~akh~	pʰakʰ 
female: keph~	kepʰ	uk"u 
woman: keph~	kepʰ	uk"u 
yellow: lu 
distant: kˈampa 
far: kˈampa 
dull: tɨ 
heavy: tɨ 
serious: tɨ 
salt: sal 
short: ʔumˈul 
snake: lacʰ 
thin: cʰacʰ 
wind: lɨpʰˈɨ 
earthworm: pelecʼˈey 
worm: pelecʼˈey 
year: ˈaɲo 
