animal: pá˗rugu | pá-rugu 
arm: ŋ́gwɪ̂ 
ashes: w˗ɛ́ːgá | w-ɛ́ːgá 
back: k˗úsu | k-úsu 
bad: ɪ́ččɪ́lu | ɪ́ččɪ́lu 
bark: kíṛi | kíṛi	wúṛi 
bark: wúṛi | kíṛi	wúṛi 
belly: s˗ərəⁿ | s-ərəⁿ 
big: ˗bɛ́nɛ́ːmbe | -bɛ́nɛ́ːmbe 
bird: ŋ˗érɛ́bi | ŋ-érɛ́bi 
bite: kʊsʊǃ | kʊsʊ! 
black: ˗uɲ(ɲ)i | -uɲi	-uɲɲi 
blood: nɛ́ru | Naru	nɛ́ru 
blow: kʊːðɪǃ | kʊːðɪ! 
bone: m˗ | m-	s-úmmɛ	summa 
bone: s˗úmmɛ | m-	s-úmmɛ	summa 
branch: ŋ˗ɛ́ːṛú | ŋ-ɛ́ːṛú 
breast: s˗immi | s-immi	simmi 
breathe: huhaŋɔǃ 
brother: lɔbɔnɛ 
burn: ka˗lə̯gɔ 
child: ŋ˗ɛmɛ | ŋ-ɛmɛ 
claw: xɛ́nǯɛ | xɛ́nǯɛ | x-ɛ́nǯɛ 
cloud: ɗ˗ít̪t̪ɛ | ɗ-ít̪t̪ɛ 
cold: ˗it̪t̪î | -it̪t̪î	ŋ- 
cold: ŋ˗ | -it̪t̪î	ŋ- 
come: áŋgʊǃ | aNg~u	áŋgʊ! 
correct: ˗ɔ́tti | -ɔ́tti 
count: táŋándu | táŋándu 
cut: hɔ́ː˗mɛ́ | hɔ́ː-mɛ́	mɛ́! 
cut: hɔ˗ŋá | hɔ́ː-mɛ́	mɛ́! 
cut: mɛ́ǃ | hɔ́ː-mɛ́	mɛ́! 
cut: ŋaǃ | hɔ́ː-mɛ́	mɛ́! 
day: siŋgi 
die: ŋɔ́˗nnɔ | Nonno	ŋɔ́-nnɔ 
dig: kɔ˗sikku | kɔ-sikku 
dirty: əṛeččá | əṛeččá 
dog: t̪ɛ́kɛ́ːlʊ́ | takalu	t̪ɛ́kɛ́ːlʊ́ 
drink: ágʊǃ | agu	ágʊ! 
dry: áːnd̪aŋa | áːnd̪aŋa 
dust: d̪˗ɒ́ːṛú | d̪-ɒ́ːṛú 
ear: k˗ɛ́ːnú | k-ɛ́ːnú	kanu 
earth: ɗ˗éːsu 
eat: lɒgʊǃ | lɒgʊ! 
egg: sɪ̂mwî | sɪ̂mwî 
eye: s˗ɪ́gi | s-ɪ́gi	sigi 
fall: hɔ́ːbɔ | hɔ́ːbɔ 
far: t̪ánd̪áːu | t̪ánd̪áːu 
father: appa | -mbi	appa 
father: ˗mbi | -mbi	appa 
fat (n.): ŋ̀˗ŋâ 
fear: bɔ́˗kɔ́˗nɛ́ːrʷ | bɔ́-kɔ́-nɛ́ːrʷ 
feather: kɛ́le | kɛ́le 
few: ittɛ́ːlɔ | ittɛ́ːlɔ 
fight: hɔ˗kkɔ́ðɔ́gi | hɔ-kkɔ́ðɔ́gˡi 
fingernail: x˗ɛ́nǯɛ | x-ɛ́nǯɛ 
finger: s˗ánd̪ri 
fire: t̪˗ɪ́ | ti	t̪-ɪ́ 
fish: aːbɛ | Naba	aːbɛ 
five: sú siːli | sú siili	sú siːli 
flow: bɔ́˗təməlakkú | bɔ́-təməlakkú 
flower: t̪˗ʊːṛɛ | t̪-ʊːṛɛ 
fly (n.): kú˗bullu 
fog: pəsullɛ 
foot: ŋ́˗gê | ŋ́-gê 
forest: d̪i˗hɪ́ːra | d̪i-hɪ́ːra 
four: yawuṛándɔ́ | yawuɽándɔ́	yawuṛándɔ́ 
fruit: t̪˗ʊːṛɛ | t̪-ʊːṛɛ 
full: t̪ábat̪t̪ɛ | tabatta	t̪ábat̪t̪ɛ 
good: ˗ɔ́tti | -ɔ́tti 
green: ˗ɔ́ːi | -ɔ́ːi 
guts: n˗úu | n-úu 
hair: ɗəŋe 
hand: ŋ˗gwî | Ngw$i	ŋ-gwî 
head: s˗â | s-â	s-âm 
head: s˗âm | s-â	s-âm 
hear: písiǃ | pisi	písi! 
heart: ɗáːga | ɗáːga 
heavy: ɪ́rrə | ɪ́rrə 
hit: kɔbɔǃ | kɔbɔ! 
hole: d̪˗ʊ́ːbu 
horn: t̪ʊːbi | tubi	t̪ʊːbi 
hunt: hɔ́˗ŋɛɗɛ́ | hɔ́-ŋɛɗɛ́ 
husband: ɔ́ːbə̺lɛ | ɔ́ːbə̺lɛ 
I: ɔŋŋi̪ | oNNi	ɔŋŋi̪ 
kill: kʊßɔ́ːðɛǃ | kʊβɔ́ːðɛ! 
knee: h˗ʊŋgʊ | h-ʊŋgʊ	huNg~u 
know: h˗ʊ˗nnʊ | h-ʊ-nnʊ 
lake: d/ɗ˗áːṛə́bə́ 
laugh: laːluǃ | laːlu! 
leaf: d̪˗aːt̪á | data	d̪-aːt̪á 
left: kúːlɛ | kúːlɛ 
leg: ŋ˗gɛ̂ | ŋ-gɛ̂ 
lie: saːdqɛ́ | saːdqɛ́ 
live: hɔ˗kʊt̪t̪é | hɔ-kʊt̪t̪é	wɛniːðɛ 
liver: t̪˗ʊŋgi | tuNg~i	t̪-ʊŋgi 
live: wɛniːðɛ | hɔ-kʊt̪t̪é	wɛniːðɛ 
long: ɔwwi 
man: g̥ʊlʊßáːɪ | pulu	pʊ́ːlu 
many: ˗ʊmmu˗ɔd̪ʊ́ːßɔk | -ʊmmu-ɔd̪ʊ́ːβɔk 
meat: w˗áːbɪ | w-áːbɪ 
moon: k˗ɪ́ːnak | k-ɪ́ːnak 
mother: pɛnɛ 
mountain: ɲ˗aɗa | x-a	xa	ɲ-aɗa 
mountain: x˗a | x-a	xa	ɲ-aɗa 
mouth: t̪˗ɔ | t̪-ɔ 
name: k˗alaŋa | k-alaŋa	kalaNa	w- 
name: w˗ | k-alaŋa	kalaNa	w- 
narrow: ómmo | ómmo 
near: ˗ut̪t̪u | -ut̪t̪u 
neck: s˗ində | s-ində 
new: ˗áːɛ | -áːɛ	ka 
night: n˗ʊ́ŋgɔ́ːla | n-ʊ́ŋgɔ́ːla	nuNg~ola 
old: ˗ɔːbi 
one: y˗ɪːlɪ | y-ɪɪlɪ	y-ɪːlɪ	yili 
person: pʊ́ːlu | pulu	pʊ́ːlu 
play: kɛ́˗bəlɔ | kɛ́-bəlɔ 
pull: aːd̪uǃ 
push: t̪ʊŋʊ 
rain: p˗ɪnɪːlɛ | p-ɪnɪːlɛ 
red: ˗ɔ́ːṛɛ | -ɔ́ːṛɛ 
right: ɔ́tti | Ngw$i	ŋ-gwî | ɔ́tti 
river: t̪˗aːbɔ | t̪-aːbɔ 
road: k˗at̪t̪ɪ́ːlɛ | kattila 
root: t̪˗oːgaʰ | t̪-oːgaʰ 
rope: t̪˗ɔ́ːṛɔ | t̪-ɔ́ːṛɔ 
rotten: uɣʊ́lannɔ | uɣʊ́lannɔ 
round: ˗aláːmsakkɔ | -aláːmsakkɔ 
rub: pə́sáǃ | pə́sá! 
salt: t̪˗əŋaːɗáːlə́ | t̪-əŋaːɗáːlə́ 
sand: t̪˗ɔɲɛ́ | t̪-ɔɲɛ́ 
say: sɔ́mmʊǃ | sɔmmʊ | t̪-ɔɲɛ́ 
say: sɔmmʊ | t̪-ɔɲɛ́ 
scratch: kxráːgʊ | kxráːgʊ 
seed: g˗ɔːṛɛ | g-ɔːṛɛ 
see: lɪgɪ́ːðɛǃ | ligi8a	lɪgɪ́ːðɛ! 
sew: hɔ́˗ŋát̪t̪ɛ | hɔ́-ŋát̪t̪ɛ 
sharp: mɛ́mmɛ́ːĺ | mɛ́mmɛ́ːĺ 
short: y˗éttu | y-éttu 
sing: hɔ˗ŋoßín̪n̪ɛ | hɔ-ŋoβín̪n̪ɛ 
sister: lɔbɔnɛ 
sit: kʊ˗d̪ɔːsɪ́ | kʊ-d̪ɔːsɪ́ 
skin: h˗eːd̪u | h-eːd̪u	hedu 
sky: d̪˗it̪t̪ɛ | d̪-it̪t̪ɛ 
sleep: sáːðɛ | sáːðɛ 
small: ˗itɛ́ːlɒ | -itɛ́ːlɒ 
smoke: w˗éːsu | w-éːsu 
smooth: ɔ́lɪ́ːlɪ | ɔ́lɪ́ːlɪ 
snake: nɪːlə | nɪːlə	pə- 
snake: pə˗ | nɪːlə	pə- 
split: hɔ˗nd̪ɛlaǃ | hɔ-nd̪ɛla! 
squeeze: kɔṛɛnnʊǃ | kɔṛɛnnʊ! 
stand: sɔllɔ 
star: s˗ɔːd̪ɔ | s-ɔːd̪ɔ	sodo 
stone: d̪˗ɔðɔ́ | do8o	d̪-ɔðɔ́ 
straight: sʊ́llʊ́d̪ɔːd̪i | sʊ́llʊ́d̪ɔːd̪i 
suck: mʊ́kkʊǃ | mʊ́kkʊ! 
sun: a˗iŋgi | a-iŋgi	siNg~i 
swell: ŋɪ́ːd̪a˗ɔnɔ 
swim: nummɔǃ | nummɔ! 
tail: s˗ilit̪t̪i | s-ilit̪t̪i 
take: lúmuǃ 
they: ɔ́ŋŋɛ | ɔ́ŋŋɛ 
thick: ɪ́rr | ɪ́rr 
thin: ˗árrɛ | -árrɛ 
think: pʊŋgʊǃ | pʊŋgʊ! 
thou: ɔŋŋʊ | oNNu	ɔŋŋʊ 
thou: ̪̪ɔ́ŋŋɔ́ | oNNu	ɔŋŋʊ 
three: y˗ɪ́t̪t̪äk | y-ɪ́t̪t̪äk	y-ɪ́t̯t̯äk 
throw: dṛɔǃ | dṛɔ! 
tie: hɔ˗mbə̯ṛá | hɔ-mbə̯ṛá 
tongue: t̪˗ʊ́lʊ́ŋɛ | tuluNa	t̪-ʊ́lʊ́ŋɛ 
tooth: s˗ínni | s-ínni	sinni 
tree: p˗eːra | pera 
turn: hɔ˗ŋə́lakɔ́ 
two: ˗ɛ́ːṛá | -ɛ́ːṛá	-έέɽa	yara 
vomit: áɗɗɪ̂ | áɗɗɪ̂ 
walk: kɔːgɔ | kɔːgɔ! 
walk: kɔːgɔǃ | kɔːgɔ! 
warm: ɔ́ːu | ɔ́ːu 
wash: kɔ́zgɛːrɔ́ | kɔ́zgɛːrɔ́ 
water: ŋ˗ɛ́ːlɛ́ | Nala	ŋ-ɛ́ːlɛ́ 
wet: ˗ɔ́sɪ́čči | -ɔ́sɪ́čči 
we: úŋŋɪ́ | uNNi 
what: jaːgá | jaːgá 
when: mákkáːga | mákkáːga 
where: kɛrɛ́ | kɛrɛ́ 
white: ˗abáčča | -abáčča 
who: ɔːbi 
wide: ˗áppɛ | -áppɛ 
wife: (o)báːrɪ́ː˗bi | báːrɪ́ː-bi	obáːrɪ́ː-bi 
wind: k˗wî | k-wî 
wing: h˗ʊ́ːbɪ́ | h-ʊ́ːbɪ́ 
wipe: pə́sáǃ | pə́sá! 
woman: p˗ʊl b˗áːri | p-ʊl b-áːri 
wood: h˗íppi 
worm: d̪˗əŋə | d̪-əŋə 
year: t̪oːbo 
yellow: ɔ́rɔ́ːsʊ | ɔ́rɔ́ːsʊ 
ash: w-ɛ́ːgá 
abdomen: s-ərəⁿ 
bigness: -bɛ́nɛ́ːmbe 
large: -bɛ́nɛ́ːmbe 
breasts: s-immi	simmi 
nail: xɛ́nǯɛ 
talon: xɛ́nǯɛ 
come from: aNg~u	áŋgʊ! 
be dead: Nonno	ŋɔ́-nnɔ 
dead: Nonno	ŋɔ́-nnɔ 
left hand: Ngw$i	ŋ-gwî 
1 sg.: oNNi	ɔŋŋi̪ 
be knowledgeable: h-ʊ-nnʊ 
lie down: saːdqɛ́ 
male: g̥ʊlʊβáːɪ 
much: -ʊmmu-ɔd̪ʊ́ːβɔk 
multiple: -ʊmmu-ɔd̪ʊ́ːβɔk 
several: -ʊmmu-ɔd̪ʊ́ːβɔk 
hill: x-a	xa	ɲ-aɗa 
title: k-alaŋa	kalaNa	w- 
nighttime: n-ʊ́ŋgɔ́ːla	nuNg~ola 
nose: x-ɪnǯɪ	xinT~i 
adulterous: y-ɪɪlɪ	y-ɪːlɪ	yili 
single: y-ɪɪlɪ	y-ɪːlɪ	yili 
that: y-ɪɪlɪ	y-ɪːlɪ	yili 
the: y-ɪɪlɪ	y-ɪːlɪ	yili 
unprincipled: y-ɪɪlɪ	y-ɪːlɪ	yili 
human: pulu	pʊ́ːlu 
human being: pulu	pʊ́ːlu 
rainy weather: p-ɪnɪːlɛ 
path: kattila 
route: kattila 
hide: h-eːd̪u	hedu 
little: -itɛ́ːlɒ 
smallness: -itɛ́ːlɒ 
rock: do8o	d̪-ɔðɔ́ 
2 sg: oNNu	ɔŋŋʊ 
you: oNNu	ɔŋŋʊ 
grind: -ɛ́ːṛá	-έέɽa	yara 
go: kɔːgɔ! 
hot: ɔ́ːu 
1 pl. inc.: uNNi 
we₁: uNNi 
whiteness: -abáčča 
who?: ɔːbi 
female: p-ʊl b-áːri 
distant: t̪ánd̪áːu 
dull: ɪ́rrə 
serious: ɪ́rrə 
close: -ut̪t̪u 
ner: -ut̪t̪u 
earthworm: d̪-əŋə 
2 pl.: ̪̪ɔ́ŋŋɔ́ 
ye: ̪̪ɔ́ŋŋɔ́ 
you all: ̪̪ɔ́ŋŋɔ́ 
3 pl.: ɔ́ŋŋɛ 
where?: kɛrɛ́ 
when?: mákkáːga 
broad: -áppɛ 
wideness: -áppɛ 
fat: ŋ̀-ŋâ 
principal wife: báːrɪ́ː-bi	obáːrɪ́ː-bi 
his mother: pɛnɛ 
my mother: pɛnɛ 
his father: -mbi	appa 
my father: -mbi	appa 
woods: d̪i-hɪ́ːra 
stick: ŋ-ɛ́ːṛú 
cord: t̪-ɔ́ːṛɔ 
flesh: w-áːbɪ 
grease: ŋ̀-ŋâ 
gut: n-úu 
insides: n-úu 
intestine: n-úu 
intestines: n-úu 
spit: ðɪkkʊ! 
laughter: laːlu! 
cogitate: pʊŋgʊ! 
reflect: pʊŋgʊ! 
smell: ʊŋɔ! 
sniff: ʊŋɔ! 
afraid: bɔ́-kɔ́-nɛ́ːrʷ 
be afraid: bɔ́-kɔ́-nɛ́ːrʷ 
fright: bɔ́-kɔ́-nɛ́ːrʷ 
alive: hɔ-kʊt̪t̪é	wɛniːðɛ 
be alive: hɔ-kʊt̪t̪é	wɛniːðɛ 
life: hɔ-kʊt̪t̪é	wɛniːðɛ 
living: hɔ-kʊt̪t̪é	wɛniːðɛ 
beat: kɔbɔ! 
strike: kɔbɔ! 
hack: hɔ́ː-mɛ́	mɛ́! 
cut open: hɔ-nd̪ɛla! 
pierce: hɔ-ŋá	ŋa! 
stab: hɔ-ŋá	ŋa! 
drop: hɔ́ːbɔ 
wring: kɔṛɛnnʊ! 
wash clothes: kɔ́zgɛːrɔ́ 
bind: hɔ-mbə̯ṛá 
fasten: hɔ-mbə̯ṛá 
tie up: hɔ-mbə̯ṛá 
enumerate: táŋándu 
number: táŋándu 
tally: táŋándu 
have fun: kɛ́-bəlɔ 
brook: t̪-aːbɔ 
stream: t̪-aːbɔ 
daylight: siŋgi 
daytime: siŋgi 
evil: ɪ́ččɪ́lu 
rot: uɣʊ́lannɔ 
filthy: əṛeččá 
soiled: əṛeččá 
blunt: -ɪ́ččɪ́lu 
damp: -ɔ́sɪ́čči 
right side: ɔ́tti 
