all: ʊːddi 
ashes: saːka 
bark: fok\o | fokʼo 
belly: gaʷ | gaᵘ 
big: arro 
bird: kaːfo 
bite: aːyk˗ka | aːyk-ka 
black: kaːr\si | kaːrʼsi 
blood: soːsi | soːsi	suz3 
bone: mɛk\ɛte | mekEt"e	mɛkʼɛte 
breast: d\anːnts | dʼanːnts	k"irt"a 
burn: eːts\˗a 
claw: ts\ɔgʊːnts | tsʼɔgʊːnts 
cloud: šaːra | šaːra 
cold: tɔːyyɔ 
come: yoːd˗da | haya	yoːd-da 
die: aːd˗de | aːd-de	hak" 
dog: kaːna | kana	kaːna 
drink: uːš\ša˗ | 3z	uːšʼša- 
dry: meːla 
ear: waː\še | waye	waːʼše 
eat: muːd˗da | muːd-da 
egg: b\ub\uːle | bʼubʼuːle 
eye: aːfe | ape	aːfe 
father: aːdda 
fat (n.): t\oːso 
fire: tama | tam3	tama 
fish: mollo | mollo	molo 
fly (n.): wut\uːnts\e 
foot: tuːke 
give: ɪng˗\ga | ɪng-ʼga 
good: loʔo 
grass: maːta 
hair: biː\nann | biːʼnann 
hand: kuːše | k"ino	kuːše 
head: omma 
hear: siːd˗ | siːd- 
heart: muts\uro | mutsʼuro 
horn: uššuːme | uSume	uššuːme 
I: ta\na | ta	taʼna 
kill: wɔːd˗ | wɔːd- 
knee: boʔe | bo7e	boʔe 
know: eːr˗ | eːr- 
leaf: baːlle | baːlle	waye 
liver: maːyye | maye	maːyye 
long: galaːla 
louse: č\uːči | C"use 
man: aːssi | 3de 
many: laːgo 
meat: aːššo 
moon: aːguna 
mountain: zuːma | d3re	zuːma 
mouth: baːdde 
name: ʊːntsi | sunz~a	ʊːntsi 
neck: ɔːnta 
new: kɪlle | k"ile	kɪlle 
night: k\aːmmanʲ | C"emo	kʼaːmmanⁱ 
one: biː\ze | bizo	biːʼze	bĭzzo 
other: peːtta 
rain: iːra 
red: zoʔo 
road: oːge | oge 
root: ts\aːpo | tsʼaːpo 
sand: šeːč\č\e | šeːčʼčʼe 
say: hɔːd˗ | hɔːd- 
seed: sɛːnye 
sit: uːt˗ | uːt- 
skin: koːʔme | ipuza	koːʔme 
sleep: geːʔh˗a | geːʔh-a 
small: guːssi 
smoke: č\uːwwa | čʼuːwwa 
snake: šoš | šoš 
stand: eːʔ˗ 
star: ts\olɪnte | tsʼolɪnte 
stone: suːči | palo	suːči 
sun: awwa 
swim: dakaːd\˗ | dakaːdʼ- 
tail: naːse 
thin: laːlle 
this: ha˗ | ha- 
thou: nɛːni | ne	nɛːni 
three: haːydzʲ 
tongue: ɪntsir | Enz~ura	ɪntsir 
tooth: gaːggo | gago	gaːggo 
tree: mɪs\si | mEza 
two: nama | Sololo	nama	šololo 
walk: hang˗\ga 
warm: bɪːn\na | bɪːnʼna 
water: waːssi | waze	waːssi 
we: nuːnna | nu	nuna 
wet: tɔy\ya 
what: aːlla 
white: boːssi 
who: oːn\ne | oːnʼne 
woman: maːč\č\i | maːčʼčʼi 
you: ɪnnɪn\na | ne	nɛːni 
every: ʊːddi 
ash: saːka 
abdomen: gaᵘ 
bigness: arro 
large: arro 
breasts: dʼanːnts	k"irt"a 
nail: tsʼɔgʊːnts 
talon: tsʼɔgʊːnts 
come from: haya	yoːd-da 
be dead: aːd-de	hak" 
dead: aːd-de	hak" 
left hand: k"ino	kuːše 
right: k"ino	kuːše 
1 sg.: ta	taʼna 
be knowledgeable: eːr- 
head louse: C"use 
male: aːssi 
much: laːgo 
multiple: laːgo 
several: laːgo 
hill: d3re	zuːma 
title: sunz~a	ʊːntsi 
nighttime: C"emo	kʼaːmmanⁱ 
nose: k"ere	kunʼke 
adulterous: bizo	biːʼze	bĭzzo 
single: bizo	biːʼze	bĭzzo 
that: bizo	biːʼze	bĭzzo 
the: bizo	biːʼze	bĭzzo 
unprincipled: bizo	biːʼze	bĭzzo 
human: 3de 
human being: 3de 
person: 3de 
rainy weather: iːra 
path: oge 
route: oge 
see: bay 
hide: ipuza	koːʔme 
little: guːssi 
smallness: guːssi 
rock: palo	suːči 
2 sg: ne	nɛːni 
grind: Sololo	nama	šololo 
hot: bɪːnʼna 
1 pl. inc.: nu	nuna 
we₁: nu	nuna 
whiteness: boːssi 
who?: oːnʼne 
female: maːčʼčʼi 
