all: bitin | bitʰˈin	bütʰˈün 
ashes: zӓḳ | zäkʼ 
bark: q:obuʁ | qobˈuʁ 
belly: šax 
big: čχi 
bird: ċimir | quš 
bite: ḳaḳakwi | kʼakʼa-kʰ-iri 
black: miḉӓ | mičʼˈä 
blood: p\i | p"i	pʼi 
bone: inḳ | ink"	inkʼ 
breast: maχar | koksu	kʰoksˈu	kʰoksˈɨ 
burn tr.: j-ek:-kwi | =ˈek-kʰ-wi	=ˈäk-kʰ-wi 
claw (nail: čimi 
cloud: unḳ | unkʼ 
cold: q:i | qiː 
come: kaʁi | kaXi	kʰˈaː=kː-wi	kʰˈaː=ɨʁ-i	kʰˈaː=ʁ-i	talkw~i 
die: ḳi | =ikʼ-ˈi	k"i	kʼ-li	kʼ-ɨlˈi 
dog: pχra | pX~ra	pχra 
drink: cuvi | cuvi	cuvri	cʰu-lˈi	cʰˈuv-rˈi 
dry: ʠi | =iqʼiː	qʼiː 
earth: inč:i | inčˈi 
ear: ṭop | t"op	tʼopʰ 
eat: ʠɨni | qʼˈan-dä 
egg: ḳaz | kʼaz 
eye: pil | pil	pʰil 
far: uzaχ | uzˈaχ 
fat n.: mi 
feather: lӓlӓg | lälˈäg 
fire: ḉӓ | C"E	čʼä 
fish: balɨʁ | bal3X	baluX	balˈɨʁ 
fly v.: učmušʠi | učʰmˈuš-qʼ-i	učʰmˈɨš-k-iri 
foot: ank: | ankʰ 
full: ċi | c"i	cʼi 
give: lӓḳwi | tʰˈä=kʼ-wi 
good: ksan 
green: sɨb 
hair: ḉar | pʰɨtʰ 
hand: kul | k"3l	kʰul 
head: miḳir | mikʼ-ˈir 
hear: ki | kli	kʰ-li 
heart: ung 
heavy: gran 
horn: vӓč | vEC	väčʰ 
I: zɨ | yä	z3	zɨ 
kill: jibi | =ˈiːb-i 
knee: nik | nik	nikʰ 
know: muxwi | mˈux-wi 
leaf: jarpaʁ | yarpaX	yarpˈaʁ 
lie: ant:ɨrʠi | ˈačːɨ-v-ri	ˈä=čːu-v-ɨri 
liver: bijar | dilik"	mičʼä biyˈar 
long: viχӓ | =iχˈä 
louse: nimċ | nimc"	nimcʼ 
man: lɨgɨld | %XEdmi	%insan	ħädmˈi 
many: iχer | iχˈer 
meat: lɨk:a | lka	lɨkˈa 
moon: vaċ | vacʼ 
mountain: mɨda | m3da	mda	mɨdˈa 
mouth: aʁzɨ | aʁzˈɨ 
name: ċu | c"u	cʼuː 
near: miʠil | miqʼ-ˈel 
neck: gardan | gardˈan 
new: taza | taza	tʰazˈa 
night: san 
nose: ḳɨtɨr | k"3t3r	kʼɨtʰ-ɨr 
not: -i- | =ˈi- 
one: sa 
person: ħӓdmi | %XEdmi	%insan	ħädmˈi 
rain: ʠula | qʼulˈa 
red: c:ɨma | cma	cɨmˈa 
road: ḳwar | kʼwar 
root: kok | kʰokʰ 
round: gongwazlɨ | gongoz-lˈu	gongoz-lˈɨ	lompʼurtʼˈum	lˈompurtum 
salt: ʠӓ | qʼä 
sand: q:um | qum 
say: li | l-i	čʼ-irˈi 
seed: tum | tʰum 
see: zaʁi | daXi	daχ-ˈi	zaXi	zˈa=ʁ-i 
short: gižӓ | gižˈä 
sit: č:uvi | č=ˈi-v-ɨri	č=ˈu-v-ɨri 
skin: ṭӓsi | t"Esi	tʼäsˈi 
sleep: ӓč:uvi | ˈačːɨ-v-ri	ˈä=čːu-v-ɨri 
small: misi | misˈi 
smoke: ximi | ximˈi 
snake: ḳaz | kʼaz 
stand: t:oχuni | tˈo=χu-n-dä 
star: pxunċ | pX~unc"	pχuncʼ 
stone: rɨċɨn | k"aC"3n	kʼačʼˈɨn	r3c"3n	rɨcʼˈɨn 
sun: ɨnʠ | 3nq"	ɨnqʼ 
swim: fczm\fcšʠi | üzmˈüš-qʼ-i 
tail: ʠaž | qʼaž 
that: hu 
thin: loḳ | kʼɨr	lokʼ 
this: du | du	ǯi 
thou: vɨ | v3	vɨ 
tongue: miċ | mic"	micʼ 
tooth: culoz | culoz	cʰulˈoz 
tree: višӓ | viSE	višˈä 
two: ḳu | k"u	kʼu	k’u 
walk (go): kaʁi 
warm: fara | farˈa 
water: xu 
we: jir | kʰi-n	yi-r	zur 
we: kin | kʰi-n	yi-r	zur 
what: ja | ya 
white: xɨrɨċ | xɨrˈɨcʼ 
who: kla | kʰla 
wind: kulak | kʰulˈakʰ 
woman: χinimḳur | χinˈi-mkʼir 
worm: mok | mokʰ 
year: fcs | üs 
yellow: ḳušḳula | kʼˈuškʼula 
every: bitʰˈin	bütʰˈün 
ash: zäkʼ 
abdomen: šax 
bigness: čχi 
large: čχi 
breasts: koksu	kʰoksˈu	kʰoksˈɨ 
burn: =ˈek-kʰ-wi	=ˈäk-kʰ-wi 
claw: čʰimˈi 
nail: čʰimˈi 
talon: čʰimˈi 
come from: kaXi	kʰˈaː=kː-wi	kʰˈaː=ɨʁ-i	kʰˈaː=ʁ-i	talkw~i 
be dead: =ikʼ-ˈi	k"i	kʼ-li	kʼ-ɨlˈi 
dead: =ikʼ-ˈi	k"i	kʼ-li	kʼ-ɨlˈi 
ground: inčˈi 
land: inčˈi 
soil: inčˈi 
fat: mi 
grease: mi 
lubricant: mi 
oil: mi 
fly: učʰmˈuš-qʼ-i	učʰmˈɨš-k-iri 
left hand: k"3l	kʰul 
right: k"3l	kʰul 
1 sg.: yä	z3	zɨ 
be knowledgeable: mˈux-wi 
lie down: ˈačːɨ-v-ri	ˈä=čːu-v-ɨri 
head louse: nimc"	nimcʼ 
male: lɨgˈɨl-d 
much: iχˈer 
multiple: iχˈer 
several: iχˈer 
flesh: lka	lɨkˈa 
hill: m3da	mda	mɨdˈa 
title: c"u	cʼuː 
nighttime: san 
adulterous: sa 
single: sa 
the: sa 
unprincipled: sa 
human: %XEdmi	%insan	ħädmˈi 
human being: %XEdmi	%insan	ħädmˈi 
rainy weather: qʼulˈa 
path: kʼwar 
route: kʼwar 
hide: t"Esi	tʼäsˈi 
little: misˈi 
smallness: misˈi 
rock: k"aC"3n	kʼačʼˈɨn	r3c"3n	rɨcʼˈɨn 
2 sg: v3	vɨ 
you: v3	vɨ 
grind: k"u	kʼu	k’u 
go: =χ-i	k-wi 
walk: =χ-i	k-wi 
hot: farˈa 
1 pl. inc.: kʰi-n	yi-r	zur 
we₁: kʰi-n	yi-r	zur 
whiteness: xɨrˈɨcʼ 
who?: kʰla 
female: χinˈi-mkʼir 
distant: uzˈaχ 
dull: gran 
serious: gran 
close: miqʼ-ˈel 
ner: miqʼ-ˈel 
earthworm: mokʰ 
