all: roßara | roβara 
arrow: naunua 
ashes: kaßu(-taka) | kaβu	kaβu-taka 
back: otame-ano 
bad: φuakxa 
bark: nakariakxa 
belly: komu-ano 
big: bageka 
bird: φutaleoka | ɸutaleoka 
black: φuφurua | ɸuɸurua 
blood: lɛßasi-ano | lɛβasi-ano 
bone: aitu-ano 
boy: kakataka 
breast: nonoʔ-ano 
brother: aroga 
burn: bapɛabeapa 
child: kakataka 
chin: kɛnaota-ano 
claw: kaitabɛ-ano 
cloud: bukiaga 
cold: musimusɪakxa 
come: uniupai 
day: aomupara 
die: obio 
dog: kɛːtuka 
drink: aitɛpapai 
dry: agarɛrɛki 
ear: mari-ano 
earth: pitoːka 
eat: iragaiopa 
egg: taumonakɑ 
elbow: paitoputubu-ano 
eye: otsiri-ano 
fall: putu 
father: atekaʔa 
fat (n.): togataka 
feather: baun-ano 
finger: kaito-ano 
fire: itakxa 
fish: oißanukxa | oiβanukxa 
five: maßai 
fly (v.): putapa 
foot: auiabawaua 
forehead: namase-ano 
forest: aba 
four: monɪsiuka 
full: agagasi 
girl: maːsearea 
give: rakitario 
good: nemoa 
green: kiraikoa 
hair: baun-ano 
hand: aße-ano | aβe-ano 
head: tanat-ano 
hear: agumanane 
heart: bubu-ano 
heavy: kuneakxa 
here: ege 
he/she: iraka 
he/she: nɛga 
he/she: nɛka 
hit: toinɛ 
house: atoakxa 
I: ndaʔa 
kill: obißiobiɛne | obiβiobiɛne 
knee: kotuφi-ano | kotuɸi-ano 
know: nɛmanɛka 
laugh: kokoßai 
leaf: tuakɑ 
leg: poy-ano 
lie: pɛrɛki 
liver: ateate-ano 
long: iruekxa 
louse: irua 
man: irabika | iraβika 
many: upwesiwaka 
meat: siobuiga 
moon: kɛkinaka 
morning: panoʔay 
mother: aoanoa 
mountain: bɛːsiakxa 
mouth: isipalo 
name: maisi-ano 
neck: napi-ano 
new: anumeapara 
night: nupara 
not: ama ama 
not: osia | ama ama 
old: aßuka 
old: aßukʰakʰa 
old: aßukaːka 
one: loßoßɛsi | loβoβɛsi 
person: iraßika | iraβika 
rain: kokea 
rat: usikɛkxa 
red: mataria 
road: oßaːkxa 
root: akarakɑ 
round: mobukuika 
sand: ararakxa 
say: osipiɛnɛ 
seed: ɛmomanaka 
see: ratabɛ 
short: tagurukxa 
shoulder: tume-ano 
sister: ßaßuatayanoa 
sit: taluʔui 
skin: banunu-ano 
sleep: pɛrɛki 
small: buriota 
smoke: (itagi-)okʰa | itagi-okʰa	okʰa 
snake: koßuɛya | koβuɛya 
spit: totoφai 
stand: turui 
star: pisiunaia 
stone: aʊφoia | aʊɸoia 
sun: naßɪnioka | naβɪnioka 
swim: tutuφuφai | tutuɸuɸai 
tail: kokuki-ano 
that: beyo 
they: nenokɔ 
they two: nɛgari 
this: naka 
thou: iʔa 
thou: misɪa | iʔa 
three: bubinika 
tomorrow: panoay 
tongue: nobe-ano 
tooth: rera-wano 
tree: ɛmomakɑ 
two: pɛnuma 
walk: ʔauʔo 
walk: posiposipa | ʔauʔo 
warm: itataupa 
water: aitɛka 
we (excl.): biʔa 
wet: akaɛruki 
we two (excl.): bɛʔa 
what: iroko 
when: amamapara 
where: aßa 
white: kakarea 
who: irokea 
wind: kʊisika 
wing: puto-ano 
woman: niakoya 
wood: tokonoakxa 
yellow: kokayaka 
yes: ilokea 
yesterday: anumɛa 
you two: mɛari 
every: roβara 
ash: kaβu	kaβu-taka 
abdomen: komu-ano 
bigness: bageka 
large: bageka 
breasts: nonoʔ-ano 
nail: kaitabɛ-ano 
talon: kaitabɛ-ano 
come from: uniupai 
be dead: obio 
dead: obio 
fly: putapa 
fly v.: putapa 
left hand: aβe-ano 
right: aβe-ano 
1 sg.: ndaʔa 
be knowledgeable: nɛmanɛka 
male: irabika 
much: upwesiwaka 
multiple: upwesiwaka 
several: upwesiwaka 
hill: bɛːsiakxa 
title: maisi-ano 
nighttime: nupara 
nose: inum-wano 
adulterous: loβoβɛsi 
single: loβoβɛsi 
the: loβoβɛsi 
unprincipled: loβoβɛsi 
human: iraβika 
human being: iraβika 
rainy weather: kokea 
hide: banunu-ano 
little: buriota 
smallness: buriota 
rock: aʊɸoia 
2 sg: iʔa 
you: iʔa 
grind: pɛnuma 
go: ʔauʔo 
whiteness: kakarea 
who?: irokea 
female: niakoya 
dull: kuneakxa 
serious: kuneakxa 
