all: kuaŋ 
arrow: toi 
ashes: sɒːno 
back: sui 
back: tiː (mo) 
bad: ka maːno 
bark: kalißo | kaliβo 
belly: koßia | koβia 
big: puːo 
bird: ule 
bite: gɒːgo 
black: keːreː 
blood: beːla 
bone: tiːle 
boy: gol tiːniŋ 
breast: tombo 
brother: moːpal 
burn: gansal ma 
child: gol tipateŋ 
chin: koŋ 
claw: ulußɒ | uluβɒ 
cloud: iɒːno 
cold: goːroneŋ 
come: gemo 
day: al 
day: ilatogo 
die: olo mo 
dog: kuɒː 
drink: meliŋ 
dry: seː 
ear: bula 
earth: kari 
eat: raŋ kal oy 
egg: kondola 
elbow: pola ku poloi 
emu: puele 
eye: penel 
fall: ga mo 
father: moːmaŋ 
fat (n.): komɛː 
feather: ul 
finger: perare 
fire: kuong | kuoŋ 
fire: kuoŋ 
fish: oŋare 
five: aːmeleŋ 
fly (v.): ma bari pigaːre 
foot: peːre itetaː 
forehead: aːre 
four: keasːso 
full: gunoka 
girl: gol rin raːl 
give: meː ma o io 
good: maːna 
green: moːleː 
hair: komɒ 
hand: poloi 
head: kela 
hear: melalo 
heart: ule ti miŋ 
heavy: buliŋ 
he/she: mo 
hit: bakel 
horn: toi 
house: melaː 
I: io 
kill: moː olo mo 
knee: nere 
know: rutuŋ 
laugh: ropiɛː 
leaf: kelambol | tamono 
leaf: tamono 
leg: peːre 
lie: baː oŋ 
liver: ule ti bonɒŋ 
long: piaː 
louse: tare 
man: tɒː tiːniŋ | titerarogo 
many: pitɒuoŋ 
meat: uragɒ 
moon: igu 
morning: gerißiŋ 
mother: moːnaŋ 
mountain: gunɒ 
mouth: koru 
name: ole 
neck: kie | kiɛː 
neck: kiɛː 
new: pitalpe 
night: togo 
not: eße | ka 
not: ka 
old: oliel 
old: peuŋ 
old: riateŋ 
one: pusuɒ 
person: titerarogo 
rain: riel 
rat: mieːle 
red: biniŋ 
road: keria 
root: kierogo 
round: ma memili 
sand: morɒːno 
say: geoŋ 
see: biso 
seed: klek | kuke 
seed: kuke 
short: pi ka pɛː 
shoulder: tanaße 
sister: moːial 
sit: muːal 
skin: tomolu 
sleep: gopolɒː 
small: ka puːo 
smoke: tiːni 
snake: teːna 
spit: go kal oŋ 
stand: roeːßiŋ 
star: kopie 
stone: lela 
sun: karege 
swim: guruŋ tiː gonu 
tail: gina | reː 
tail: reː 
that: pe 
they: neŋ 
they two: neŋ tereŋ 
this: po 
thou: ne 
thou: ŋo | ne 
three: tetepe kosuɒ 
tomorrow: ikeɒːno 
tongue: ra\al | raʼal 
tooth: mire 
tree: tiːnel 
two: tetepe 
walk: bari | boi 
walk: boi 
wallaby: lueta 
warm: kareː 
water: gonu 
we (excl.): maŋ 
we (incl.): ñang 
we: mang 
wet: kuɛː 
we two (excl.): maŋ tereŋ 
what: kale 
when: pikoloŋ 
where: ikɒ 
white: paːle 
who: anto 
wind: ilu 
wing: pageː 
woman: raːl 
wood: te tiːnel 
yellow: kaːgeː 
yes: oia 
yesterday: keːta 
you: ngo | ne 
you two: ŋo tereŋ 
every: kuaŋ 
ash: sɒːno 
abdomen: koβia 
bigness: puːo 
large: puːo 
breasts: tombo 
nail: uluβɒ 
talon: uluβɒ 
come from: gemo 
be dead: olo mo 
dead: olo mo 
fly: ma bari pigaːre 
fly v.: ma bari pigaːre 
left hand: poloi 
right: poloi 
1 sg.: io 
be knowledgeable: rutuŋ 
male: tɒː tiːniŋ 
much: pitɒuoŋ 
multiple: pitɒuoŋ 
several: pitɒuoŋ 
hill: gunɒ 
title: ole 
nighttime: togo 
nose: taliː 
adulterous: pusuɒ 
single: pusuɒ 
the: pusuɒ 
unprincipled: pusuɒ 
human: titerarogo 
human being: titerarogo 
rainy weather: riel 
hide: tomolu 
little: ka puːo 
smallness: ka puːo 
rock: lela 
2 sg: ne 
grind: tetepe 
go: boi 
whiteness: paːle 
who?: anto 
female: raːl 
dull: buliŋ 
serious: buliŋ 
