all: gera tefou | kwalu	sui	ʔae	ʔafuta 
and: fainia | ma 
animal: kui 
ashes: afuafu | fua-na ere 
back: ʔogina | suli- 
bad: tā 
bark: ʔuŋe ʔai 
because: sulia 
belly: rake | kelo-	kutu-	rake- 
bird: manu 
bite: ʔalea | ʔala 
black: bora | kokoradoa 
blood: ʔabu | abu	ʔabu 
blow: ʔufulia | sau	ufi	ōru	ʔufu 
bone: ʔ̊ogi | suli	suli- 
breast: susu | susu	susu- 
breathe: maŋola 
burn: harufia | sasu	sū 
child: wrla 
cloud: barobaro 
cold: gʷagʷaria | gwagwalila 
come: lea mai | lae mai 
correct: aolo 
count: etemia | idu 
cut: ʔolea | tofu	toto	ʔiri 
die: mae 
dig: ʔelia 
dirty: tʰona | bili	fafulu 
dog: kui | [ku]kui	kui	kukui 
drink: gʷou | iNo	ʔiŋo 
dry: laŋa | lalaŋa 
dull: ūru | gulu | dada	fō	lomu	ūru 
dust: afuafu | afuafu-na gano 
ear: ʔaliŋa | aliNa	ʔaliŋa 
earth: gano 
empty: gʷou 
eye: mā | ma	mā 
fall: bə nэmatetə | [ʔa]ʔaru 
far: tau | tau	tou 
father: mā | ama 
fat (n.): raraŋa 
fear: mou 
few: laŋi si ʔoro 
fingernail: siribuku 
fire: këmɔřu | ere 
fish: iʔa | i7a	īʔa 
five: lima 
float: hakohakoj 
flower: tageʔai | taka 
flow: iga | igwa	toŋo 
fly (v.): lofo 
fog: dasa 
foot: ʔae-na 
forest: lagano | kwaena 
four: fai 
frog: [furoko] 
fruit: fueai | fufua 
full: fuŋu 
give: falea 
good: diana 
grass: loua | murua 
green: akasa | akasa	maʔa 
guts: ogana | kakade ŋali	oga 
hair: ifu kete 
hand: ʔaba | aba	ʔaba 
head: kete | kawu	kwou 
hear: roŋoa | roNo	roŋo 
heart: maŋo 
heavy: gulu 
he: nia 
hit:   kʷaea | kwae	naŋa	tō 
how: autā | ʔutā 
hunt: fafana 
husband: ārai nia | kwai	ārai 
I: nau 
in: ilalo | i lalo 
kill: hauŋia | kwae	lima 
knee: urūru-na 
know: haitamana | saitoma	tomatafa 
lake: ʔosi | namo 
large: baita | bao 
laugh: waela | gā 
leaf: ʔbe | elo 
left: balimouli 
leg: ʔaena 
lie: teohaegano 
live: mouri 
long: tekʷa | tekwa	tikwa 
louse: ū | u	ʔū 
man: ārai | imola	toa	tōa 
many: ʔoro 
meat: mariko | fasio	mariko 
moon: sinali | madama 
mother: tē 
mountain: ūwo 
mouth: fakana | faka- 
name: hatana | sata	sata- 
narrow: logo | logo	susu|kofi 
near: garaŋia | i fafo	ʔae 
neck: ʔe ʔlua 
new: falu | falu	fālu 
night: rodo | boNi	boŋi	rodo 
nose: ŋora | gwalusu	gw~alusu 
old:   waru 
one: eta | eta	tai	tāi	ɛta 
person: ʔai | imola	toa	tōa 
play: labala 
pull: lafia 
push: suia 
rain: uta 
red: kekero | kekero	ʔaʔabua 
right: baliaolo | aba	ʔaba 
river: kafo 
road: tala 
root: lali | gwalu	kobe	lali 
rope: ʔoko 
rotten: meme | fura	mumū 
round: viviloho 
rub: usua 
salt: asila 
sand: one 
say: haea | bae | one 
sea: asi 
seed: migedō 
sew: taia | tai-a 
sharp: lasia | ʔala. au 
short: kukuru 
sing: ŋu 
sit: gʷouru | gwouru 
skin: ʔuŋa | uya	ʔuya 
sky: lofohalo | salo 
sleep: teo | eno	teo 
small: toʔou | marabibi	toʔou 
smell: moko | nonomoko 
smoke: hasu | sasu 
smooth: dolo 
snake: loi | wā 
some: si do lau 
spit: ŋisu 
split: fora | afita	ala	fola 
stab: labua | sugi 
stand: take 
star: bubulu 
stick: kubou | sara 
straight: ʔolo ʔoloa 
suck: notofia | ʔomi 
sun: hato 
tail: kikiu | kukui 
they: gera | ida|ro 
thick: ʔubuʔubua 
think: manatasi | manata	tago 
thin: refe refea 
thou: gomolu | i7oe	iʔoe 
thou: niʔoe | i7oe	iʔoe 
three: olu 
throw: ʔuia 
tie: kania | firi	kani	āri 
tongue: meana | mea	mea- 
tree: ʔai 
turn: fakopo 
two: rua 
vomit: moa 
warm: ʔago ʔago 
we: gemelu | gami	gia 
wet: gʷini | gwini 
what: tā | tafa	tā 
when: aŋita 
which: dō tā 
white: kʷao | kwao 
who: tei | atei 
why: ʔutā 
wide: reba | rereba 
wife: ʔafe nia | kwai	ʔafe 
wind: ōru 
woman: ʔinitei | geni 
wrong: garo 
year: ŋali | falisi 
yellow: gogoa 
every: kwalu	sui	ʔae	ʔafuta 
ash: fua-na ere 
abdomen: kelo-	kutu-	rake- 
big: bao 
bigness: bao 
breasts: susu	susu- 
burn tr.: sasu	sū 
come from: lae mai 
be dead: mae 
dead: mae 
eat: ʔani 
egg: saolu 
feather: ʔefo 
fly: lofo 
fly v.: lofo 
hair: ifu 
left hand: aba	ʔaba 
1 sg.: nau 
be knowledgeable: saitoma	tomatafa 
lie: teo 
lie down: teo 
liver: fou	saefou	sae|fou- 
head louse: u	ʔū 
male: wane 
title: sata	sata- 
neck: lua 
nighttime: boNi	boŋi	rodo 
adulterous: eta	tai	tāi	ɛta 
single: eta	tai	tāi	ɛta 
that: nae	ne 
the: eta	tai	tāi	ɛta 
unprincipled: eta	tai	tāi	ɛta 
human: imola	toa	tōa 
human being: imola	toa	tōa 
rainy weather: uta 
path: tala 
route: tala 
see: ada	riki 
hide: uya	ʔuya 
little: marabibi	toʔou 
smallness: marabibi	toʔou 
rock: fou 
stone: fou 
swim: garu ʔaraŋa 
this: na 
2 sg: i7oe	iʔoe 
you: i7oe	iʔoe 
tooth: lifo 
grind: rua 
go: fali 
walk: fali 
hot: ʔago 
warm: ʔago 
water: kafo 
1 pl. inc.: gami	gia 
we₁: gami	gia 
whiteness: kwao 
who?: atei 
female: geni 
distant: tau	tou 
serious: gulu 
close: i fafo	ʔae 
ner: i fafo	ʔae 
thin: refe 
earthworm: wā 
worm: wā 
2 pl.: gamu 
ye: gamu 
you all: gamu 
3 pl.: ida|ro 
where: ifai 
where?: ifai 
when?: aŋita 
how?: ʔutā 
other: madiu 
broad: rereba 
wideness: rereba 
principal wife: kwai	ʔafe 
his mother: tē 
my mother: tē 
his father: ama 
my father: ama 
woods: kwaena 
branch: sara 
cord: ʔoko 
flesh: fasio	mariko 
fat: raga	ragufa 
grease: raga	ragufa 
wing: ʔaba 
gut: kakade ŋali	oga 
insides: kakade ŋali	oga 
intestine: kakade ŋali	oga 
intestines: kakade ŋali	oga 
breath: maŋo 
breathe: maŋo 
laughter: gā 
cogitate: manata	tago 
reflect: manata	tago 
sniff: nonomoko 
afraid: mou 
be afraid: mou 
fright: mou 
alive: mouri 
be alive: mouri 
life: mouri 
living: mouri 
beat: kwae	naŋa	tō 
strike: kwae	naŋa	tō 
hack: tofu	toto	ʔiri 
cut open: afita	ala	fola 
pierce: sugi 
scratch: gama	garu 
dig: ʔeli 
drop: [ʔa]ʔaru 
grasp: dau ʔana 
hold: dau ʔana 
hold in arm: dau ʔana 
squeeze: fele	losi 
wring: fele	losi 
throw: ʔui 
bind: firi	kani	āri 
fasten: firi	kani	āri 
tie up: firi	kani	āri 
enumerate: idu 
number: idu 
tally: idu 
ocean: asi 
evil: tā 
rot: fura	mumū 
filthy: bili	fafulu 
soiled: bili	fafulu 
blunt: dada	fō	lomu	ūru 
damp: gwini 
right side: aolo 
left: mouli 
inside: i lalo 
if: lea	ʔa|na 
