all: fɛo	fɛw	ɓiɓi 
every: fɛo	fɛw	ɓiɓi 
ash: dɔ-khɔ	tʰona	tʰoʼo 
ashes: dɔ-khɔ	tʰona	tʰoʼo 
bark: kho-rɛ 
abdomen: benɛ	bɪ́nɛ̃́	bɪ́nɛ̃́ sʊ̀nɔ̃ʏ̈ 
belly: benɛ	bɪ́nɛ̃́	bɪ́nɛ̃́ sʊ̀nɔ̃ʏ̈ 
big: kõtĩn	kɔ̃tĩː 
bigness: kõtĩn	kɔ̃tĩː 
large: kõtĩn	kɔ̃tĩː 
bird: ʔlomin	ʔlomin-ə 
bite: doɔn	dwɔ̃n	dɔ 
black: biːruː	da br 
blood: tɔmin	tɔ̀mɪ̃ʏ̈n	tɔ̀mɪ̃ʏ̈n sʊ̀nɔ̃ʏ̈ 
bone: kʰùb	kʰʊ̀bà 
breast: ɪ́lɛ̃́	ɪ́lɛ̃́ sʊ̀nɔ̃ʏ̈	ʔilne	ʔilɛ̃- 
breasts: ɪ́lɛ̃́	ɪ́lɛ̃́ sʊ̀nɔ̃ʏ̈	ʔilne	ʔilɛ̃- 
claw: nyɔ̃bi-khurɛ	nébí khũʏ̈ṹ	nébí kẁĩ́ 
nail: nyɔ̃bi-khurɛ	nébí khũʏ̈ṹ	nébí kẁĩ́ 
talon: nyɔ̃bi-khurɛ	nébí khũʏ̈ṹ	nébí kẁĩ́ 
cloud: ĩdolõpaː-r	ɟɔ̀lɔ̃ʏ̈paàr	ɟɔ̀lɔ̃ʏ̈pànãʏ̈ 
cold: da wi	ʔiː 
come: ɪ̃ʼɪ̃n	ʔẽ 
come from: ɪ̃ʼɪ̃n	ʔẽ 
be dead: khi	kʰir 
dead: khi	kʰir 
die: khi	kʰir 
dog: bena	biːn	bɛnã	bɪ̃ʼɪ̃n 
drink: nyɔr	yɔ	ɲwɔr 
dry: da kʰɪʼɪ	khiː- 
ear: nũũʏ̈ sʊ̀nɔ̃ʏ̈	nũʏ̈ũ	nũː 
eat: kho	kʰor 
egg: pana	panã	paʼar	paːr 
eye: yinə	yiri	yínə̃́	yírí 
feather: šuːn 
fire: dɔʼɔ	dɔː 
fish: thom	thom-a	tʰʊm	tʰʊmã 
fly: ufir	ʔubi 
fly v.: ufir	ʔubi 
foot: nɔː	nɛː 
full: da hiri	hiː 
give: ha	har	ʔlaga 
good: boɔ	bɔ-	bɔʼɔrɪ 
hair: sũũʏ̈n	sũũʏ̈n sʊ̀nɔ̃ʏ̈	šuːn 
hand: nyɔː	yɔ̃-	ɛ̃ː	̩ 
left hand: nyɔː	yɔ̃-	ɛ̃ː	̩ 
right: nyɔː	yɔ̃-	ɛ̃ː	̩ 
head: yoː	yʊ́ʊ	yʊ́ʊ sʊ̀nɔ̃ʏ̈ 
hear: ne	ɲɛrɪ 
heart: kpoːr 
horn: pʊ́mã́	pʊ́mã́ sʊ̀nɔ̃ʏ̈	ʔom-	ʔone 
1 sg.: in-	mi	mɛrɛ	mɪrɛ 
I: in-	mi	mɛrɛ	mɪrɛ 
kill: ko	kʊr 
knee: nɔ-khelu 
be knowledgeable: ǯe 
know: ǯe 
leaf: faʼa	faʼa sʊ̀nɔ̃ʏ̈	faː 
lie: pʰɪʼɪn	ʔyɛl 
lie down: pʰɪʼɪn	ʔyɛl 
liver: haː-r 
long: da gbãʼã	gbãː 
male: kuon	kũʏ̈ũn	kɔ̀ǹã 
man: tibil	tíbi̪lá	tíbíl 
many: bərəm	ǯɔː	ɟɔɟɔ 
much: bərəm	ǯɔː	ɟɔɟɔ 
multiple: bərəm	ǯɔː	ɟɔɟɔ 
several: bərəm	ǯɔː	ɟɔɟɔ 
flesh: nuːn 
meat: nuːn 
moon: po-r	pór	pɔ́rá 
hill: gɔ̃goɔn	gɔ̃gwɔ̃n	gɔ̃gɔnã 
mountain: gɔ̃goɔn	gɔ̃gwɔ̃n	gɔ̃gɔnã 
mouth: noɔ	nwɔ	nwɔ sʊnɔ̃ 
name: ìrì	ɪ̀rɪ̀ sʊ̀nɔ̃ʏ̈	ʔi-ri 
title: ìrì	ɪ̀rɪ̀ sʊ̀nɔ̃ʏ̈	ʔi-ri 
neck: foɔr	fɔ- 
new: da pʰaʼa	phaː 
night: ditinɔ	dɪ̀tʊ́nɔ̩̃ 
nighttime: ditinɔ	dɪ̀tʊ́nɔ̩̃ 
nose: meŋkaːr	mɪ̀kànà	mɪ̃ʏ̈kàar 
not: -aʔ	-gaʔ	fãʼã 
adulterous: byl	bɛːl	bɪɛl 
one: byl	bɛːl	bɪɛl 
single: byl	bɛːl	bɪɛl 
that: le	ʊrɛ 
the: byl	bɛːl	bɪɛl 
unprincipled: byl	bɛːl	bɪɛl 
human: tibil	tíbi̪lá	tíbíl 
human being: tibil	tíbi̪lá	tíbíl 
person: tibil	tíbi̪lá	tíbíl 
rain: thaŋgba	tʰã́gbá ɲẃɔ̃ʏ̈n 
rainy weather: thaŋgba	tʰã́gbá ɲẃɔ̃ʏ̈n 
red: da syɛ	šeɛ 
root: nɔʼɔ	nɛʼɛ	thir-nɔː 
round: bilẽː	da blẽblẽ 
sand: bàlã́ tʰɪ̪ʼɪ́	gbalãkɔthin 
say: sor	šo 
see: ye	yɪr 
seed: bi-ri	de-rɛ 
sit: togi	toʼori	toː 
hide: lor	lúu	lúu-sʊ̀nɔ̃ 
skin: lor	lúu	lúu-sʊ̀nɔ̃ 
sleep: daʼarɪ	daːr 
little: bi	bu	de buʼu	ʔlũː 
small: bi	bu	de buʼu	ʔlũː 
smallness: bi	bu	de buʼu	ʔlũː 
smoke: osiʼir	osiʼir sʊ̀nɔ̃ʏ̈	ʔišiː-r 
star: ɪ̃ʏ̈pórbìr	ʔyepələmbiri 
rock: bokaː-r	bʊ́káar̀	bʊ́kánãʏ̈ 
stone: bokaː-r	bʊ́káar̀	bʊ́kánãʏ̈ 
sun: wi-ri	wɪ̀ɪrɪ̀ 
swim: phe	phenɛ 
tail: sʊʊ̀ sʊ̀nɔ̃ʏ̈	sʊ̀ʊ	šoː 
this: kɛ	ʊrɛ 
2 sg: fi	fɛrɛ	fɪrɛ 
thou: fi	fɛrɛ	fɪrɛ 
you: fi	fɛrɛ	fɪrɛ 
tongue: delẽbi-ri	dèlébír̀	délébé 
tooth: nyema	nyenɛ	ɲɪ́mã́	ɲɪ́mã́ sʊnɔ̃ 
grind: -yɔ̃	yɛɲɔ	yẽy˜ ɔ 
two: -yɔ̃	yɛɲɔ	yẽy˜ ɔ 
go: ɪ̃ʼɪ̃rɪ	ʔeːr 
walk: ɪ̃ʼɪ̃rɪ	ʔeːr 
water: nyoɔn	yoɔn	ɲwɔ̃n 
what: anye	aɲɛ 
white: buloː	da blo 
whiteness: buloː	da blo 
who: amɛ 
who?: amɛ 
female: khɛr	kʰɛ́r	kʰɛ́rá 
woman: khɛr	kʰɛ́r	kʰɛ́rá 
yellow: doːn 
distant: hʊ̃nɔ̃nɪ̃ 
far: hʊ̃nɔ̃nɪ̃ 
dull: da dʊfrɔ 
heavy: da dʊfrɔ 
serious: da dʊfrɔ 
close: gbɔrɔ̃ nɪ̃ 
near: gbɔrɔ̃ nɪ̃ 
ner: gbɔrɔ̃ nɪ̃ 
salt: laʼa sʊ̀nɔ̀	laʼan 
short: da gburu 
year: yɛ̀nãʏ̈	yɛ̀r 
