all: mbák̚	păt	wapat 
every: mbák̚	păt	wapat 
bark: hói 
abdomen: bil	bɪl	ɓíl 
belly: bil	bɪl	ɓíl 
big: hun	kúnakɛ 
bigness: hun	kúnakɛ 
large: hun	kúnakɛ 
bird: ndoi	ndòi	ndóe 
bite: loŋ 
black: airag	làk-rì	yir	ɗàk-mà 
blood: sem	sém	sɛm	çɛm	šɛm 
bone: huku	húku 
breast: haN	pam	paːm	pám 
breasts: haN	pam	paːm	pám 
cold: tel 
come: dyiː	giː	ji	zina 
come from: dyiː	giː	ji	zina 
be dead: hu	hul	hʊ 
dead: hu	hul	hʊ 
die: hu	hul	hʊ 
dog: goi	gwoi	gói	ɟɔ́ːɛ 
drink: dyoː	fejona	nsoː	nǯona 
dry: hok	hɔgwaː	hɔhɛ 
ear: suk	suk̚	súk	šu 
eat: laka	lă	sũl 
egg: par	pár	pǽr 
eye: yar 
feather: fòr	fúrmà	purma	tẽ́ 
fire: gu	hora	hòra	hɔ́rɔ 
fish: njui	nzúɪ	nǯʷĩ́ 
fly: zo	čoː 
fly v.: zo	čoː 
foot: bɔ	harvɔk	βɔk̚ 
full: gar	garake	mbar 
give: hina	hiː 
good: bel	bɛlakɛ 
hair: hói sɔ	ti	tɛ 
hand: birin	landɔk̚	ndok	ndók 
left hand: birin	landɔk̚	ndok	ndók 
right: birin	landɔk̚	ndok	ndók 
head: soa	sä	sɔ̃	sṍ	tul 
hear: la 
heart: lau	làu	ləu 
horn: ti*u*	tyẽ́u 
1 sg.: mi	mì 
I: mi	mì 
kill: yiː	yɪ 
knee: kór	sɔkɔr	sɔ̃́ːkɔr 
be knowledgeable: ma 
know: ma 
leaf: godam	gwoi	gò ɗàm 
liver: lau	làu 
long: pe 
head louse: goNa 
louse: goNa 
male: nzúärkɛ	nǯu wara 
man: njuk	nzuk̚	nǯuk	nǯùk 
many: dabake	dap	dapa	dave 
much: dabake	dap	dapa	dave 
multiple: dabake	dap	dapa	dave 
several: dabake	dap	dapa	dave 
moon: séu	šeəu 
hill: gunNggau	ngau	ngáu	sadolu 
mountain: gunNggau	ngau	ngáu	sadolu 
mouth: hau	háu	nza 
name: rìŋ	rɪŋ 
title: rìŋ	rɪŋ 
neck: mbártsɔl	sòl	sɔl 
new: ?fe	feke 
night: suN	suŋ	súŋ	sʊm	šuŋ 
nighttime: suN	suŋ	súŋ	sʊm	šuŋ 
nose: hok	huɔk	hɔ	hɔk̚	hṍk 
not: -yà	-yá	sá … ya	ya 
adulterous: soN	soŋ	sóŋ	sɔŋ 
one: soN	soŋ	sóŋ	sɔŋ 
single: soN	soŋ	sóŋ	sɔŋ 
that: aídɔ 
the: soN	soŋ	sóŋ	sɔŋ 
unprincipled: soN	soŋ	sóŋ	sɔŋ 
human: njuk	nzuk̚	nǯuk	nǯùk 
human being: njuk	nzuk̚	nǯuk	nǯùk 
person: njuk	nzuk̚	nǯuk	nǯùk 
rain: mbam	mbàm	mbáːm 
rainy weather: mbam	mbàm	mbáːm 
red: si	sin	çin	çinake 
path: mafil 
road: mafil 
route: mafil 
root: nṹ	sãʏ̈u	ɲṹ 
sand: zarándɪ 
say: baː	faŋ	faŋa	mbaː	ɓa-ɓè 
see: ko	kɔ 
seed: mbàr	tár 
sit: kaːb	mbeː 
hide: NgaN	ngaŋ	ngàŋ	nàŋ 
skin: NgaN	ngaŋ	ngàŋ	nàŋ 
sleep: naː	nám 
little: báːna	gún	nzɪki	nǯi̪ki	tɛː 
small: báːna	gún	nzɪki	nǯi̪ki	tɛː 
smallness: báːna	gún	nzɪki	nǯi̪ki	tɛː 
smoke: súku 
star: ro	ru	rù 
rock: asau	sau	sauk	sàu	šəu 
stone: asau	sau	sauk	sàu	šəu 
sun: sesei	seséː	sé	šiše 
swim: nzu 
tail: ták 
this: -kù	-àú	dɔ 
2 sg: a	mo	mà	mù	à 
thou: a	mo	mà	mù	à 
you: a	mo	mà	mù	à 
tongue: lilem	lima	lèlém	líma 
tooth: sel	sél	tçɛl	čel	čen 
tree: kpu 
grind: doa	dóà	ndóːa	ɗua 
two: doa	dóà	ndóːa	ɗua 
go: se-na	tseː 
walk: se-na	tseː 
hot: ašid da 
warm: ašid da 
water: bi	inǯi	mbi	mbì 
1 pl. inc.: na ri	ná 
we: na ri	ná 
we₁: na ri	ná 
what: aniː	ni	piː	à-fé 
white: fuku	fúk̚	pɪpú 
whiteness: fuku	fúk̚	pɪpú 
who: adyɛ́ː	gɛː	à-zé 
who?: adyɛ́ː	gɛː	à-zé 
female: nǯu wi	win nǯuk	wúndyu	βóɪ 
woman: nǯu wi	win nǯuk	wúndyu	βóɪ 
distant: ɗi 
far: ɗi 
dull: zi 
heavy: zi 
serious: zi 
close: doŋ	ɓèl 
near: doŋ	ɓèl 
ner: doŋ	ɓèl 
salt: tom	tòm 
snake: sòi	šoi	šóːi 
wind: kúna	kʊkúna 
year: kai	písì	pɪ́sɪ 
