all: tioʔ-tioʔ | sadoño 
and: ǰo | dan 
animal: binataŋ 
ashes: abu 
back: puŋgu{ə}ŋ | puŋguaŋ 
bad: buruəʔ | jaeʔ 
bark: kuliʔ kayu 
because: [karano] 
belly: paruyʔ | paruit 
bird: uŋgeh | buruaŋ 
bite: gigi? | maŋgigiʔ 
black: itam 
blood: darah 
blow: ambuyh | burambuih 
bone: tulaŋ | tulaN	tulang 
breast: susu 
breathe: aŋoʔ | baaŋoʔ 
burn: paŋgaŋ | mambaka 
child: anaʔ 
cloud: awan 
cold: diŋin 
come: dataŋ | tibo 
correct: bana 
count: etoŋ | maetoŋ 
cut: čatuəʔ | maŋareʔ 
die: mati 
dig: gali | maŋali 
dirty: kumuəh | kumuah 
dog: añjiəŋ | anjiaŋ	anj~iaN 
drink: minun 
dry: kariəŋ | kariaŋ 
dull: maǰa | bareʔ | buntu 
dust: abu 
ear: taliŋo | taliNo	taliŋo 
earth: [bumi] 
egg: taluə | talua 
empty: kosoŋ 
eye: mato 
fall: rareh | jatuah 
far: ǰauəh | juuah 
father: bapaʔ 
fat (n.): lamaʔ 
fear: takuya | takuiʔ 
few: sa-keteʔ 
fingernail: faha-n era-n 
fire: api 
fish: ikaη | ikan 
five: limo 
float: ma-rapuəŋ 
flower: buŋo 
flow: ma-iliə | mailie 
fly (v.): tabaŋ 
fog: kabuyʔ | kabuiʔ 
foot: kaki 
forest: rimbo 
four: ampeʔ | ampek	ampeʔ 
frog: koñčeʔ 
fruit: buah | buah-buahan 
full: panuəh 
give: agi{ə}h 
good: eloʔ 
grass: ɯmpuyʔ | rumpuiʔ 
green: iǰaw | ijau 
guts: paruyʔ-pañǰaŋ | tambonsu 
hair: abu{ə}ʔ | abuaʔ 
hand: taŋan | taNan	taŋan 
head: [kapalo] 
hear: daŋa | mandaŋa	mand~aNa 
heart: ǰantu{ə}ŋ 
heavy: bareʔ 
he: iño 
hit: lakaʔ | manokoʔ 
horn: tandu{ə}ʔ 
how: ba-a | baʔa 
hunt: ba-buru | baburu 
husband: laki 
ice: [es] 
I: den | ambo	amb~o 
if: ǰokoʔ | kalau 
in: didalam | di dalam 
kill: bunu{ə}h | mambunuah 
knee: lutuyʔ 
know: tau 
lake: danaw | danau 
large: gadaŋ 
laugh: galaʔ 
leaf: daun 
left: kida 
leg: kakí 
lie: ba-goleʔ | bagoleʔ 
live: iduyʔ | iduiʔ 
liver: ati | ati	atĭ 
long: pad\ǰaŋ | panjaʔ 
louse: kutu 
man: uraŋ laki-laki | uraN	uraŋ 
many: bañaʔ 
meat: dagi{ə}ŋ | dagiaŋ 
moon: bulan 
mother: andeh | amaʔ 
mountain: gunuəŋ 
mouth: araŋ | muncuaŋ 
name: [namo] | %namo	namo 
narrow: sampiʔ 
near: dakeʔ 
neck: kudu{ə)ʔ | lihie 
new: baru 
night: malam 
nose: idu{ə}ŋ | iduaN	iduaŋ 
old: tuo 
one: čieʔ | Cie7	ciek	cieʔ 
person: uraŋ | uraN	uraŋ 
play: main 
pull: elo 
push: tulaʔ 
rain: uǰan | ujan 
red: sirah 
right: suoʔ | taNan	taŋan 
river: suŋay 
road: labu{ə}h | labuah 
root: ureʔ 
rope: tali 
rotten: busuəʔ | busuaʔ 
round: buleʔ 
rub: gosoʔ 
salt: [garam] 
sand: pasi{ə} | kasiaʔ 
say: ba-[kato] | maŋeceʔ | kasiaʔ 
sea: lawiʔ gadaŋ | lauiʔ 
seed: [biǰo] 
sew: ǰaia | manjaiʔ 
sharp: taǰam | tajam 
short: pendeʔ 
sing: ma-ñañi 
sit: dudu{ə}? | duduaʔ 
skin: kuliʔ | kulik 
sky: laŋiʔ 
sleep: laloʔ 
small: keteʔ 
smell: idu | maidu 
smoke: asoʔ 
smooth: aluyh 
snake: ula 
some: sa-keteʔ 
spit: ma-liuə | maliue 
split: balah | mambalah 
stab: tikam | manikam 
stand: taga7 | tagaʔ 
star: bintaŋ | bintang	bint~aN 
stick: tuŋkeʔ | dahan 
suck: mañusu | maisoʔ 
sun: mato ari 
tail: iku{ə} | ikua 
they:  iño | raŋ tu 
thick: taba 
think: mar-[pikkir] | bapikie 
thin: mipih | tipih 
thou: aŋ | aŋ	kāu	wauN	wauŋ 
thou: [kali] an | aŋ	kāu	wauN	wauŋ 
three: tígo | tigo 
throw: lantì{ə}ŋ | mambaeka... 
tie: kabeʔ | mangabeʔ 
tongue: lidah 
tooth: gigi 
tree: bataŋ 
turn: bali{ə}ʔ-an 
two: duo 
vomit: mutah 
warm: aŋeʔ | paneh 
we: kami | kito 
wet: basah | busah 
what: apo 
when: bilo 
which: nan ma 
white: putiэh | putiah 
who: si-apo | sia 
why: maŋa 
wide: leba | laweh 
wife: bini 
wind: aŋin | angin 
wing: sayoʔ 
woman: uraŋ padusi 
worm: čači{ə}ŋ | caciaŋ 
wrong: salah 
year: taun 
yellow: kuniəŋ | kuniaŋ 
every: sadoño 
ash: abu 
abdomen: paruit 
big: gadaŋ 
bigness: gadaŋ 
breasts: susu 
burn tr.: mambaka 
come from: tibo 
be dead: mati 
dead: mati 
eat: makan 
feather: bulu 
fly: tabaŋ 
fly v.: tabaŋ 
left hand: taNan	taŋan 
head: kapalo 
1 sg.: ambo	amb~o 
be knowledgeable: tau 
lie down: bagoleʔ 
head louse: kutu 
male: laki-laki 
title: %namo	namo 
nighttime: malam 
adulterous: Cie7	ciek	cieʔ 
single: Cie7	ciek	cieʔ 
that: tu 
the: Cie7	ciek	cieʔ 
unprincipled: Cie7	ciek	cieʔ 
human: uraN	uraŋ 
human being: uraN	uraŋ 
rainy weather: ujan 
path: labuah 
route: labuah 
see: malie7	malieʔ 
hide: kulik 
little: keteʔ 
smallness: keteʔ 
rock: batu 
stone: batu 
swim: baranaŋ 
this: iko	ko 
2 sg: aŋ	kāu	wauN	wauŋ 
you: aŋ	kāu	wauN	wauŋ 
grind: duo 
go: bajalan 
walk: bajalan 
hot: paneh 
water: aie 
1 pl. inc.: kito 
we₁: kito 
whiteness: putiah 
who?: sia 
female: padusi 
woman: padusi 
distant: juuah 
serious: bareʔ 
close: dakeʔ 
ner: dakeʔ 
salt: garam 
short: pende 
earthworm: caciaŋ 
3 pl.: raŋ tu 
where: dima 
where?: dima 
when?: bilo 
how?: baʔa 
other: lain 
broad: laweh 
wideness: laweh 
fat: gomoʔ 
narrow: sampi 
principal wife: bini 
his mother: amaʔ 
my mother: amaʔ 
father: apaʔ 
his father: apaʔ 
my father: apaʔ 
woods: rimbo 
branch: dahan 
cord: tali 
flesh: dagiaŋ 
grease: gomoʔ 
gut: tambonsu 
insides: tambonsu 
intestine: tambonsu 
intestines: tambonsu 
breath: baaŋoʔ 
laughter: galaʔ 
cogitate: bapikie 
reflect: bapikie 
sniff: maidu 
afraid: takuiʔ 
be afraid: takuiʔ 
fright: takuiʔ 
alive: iduiʔ 
be alive: iduiʔ 
life: iduiʔ 
living: iduiʔ 
beat: manokoʔ 
strike: manokoʔ 
hack: maŋareʔ 
cut open: mambalah 
pierce: manikam 
scratch: maŋgauiʔ 
drop: jatuah 
grasp: mamaeiʔ 
hold: mamaeiʔ 
hold in arm: mamaeiʔ 
squeeze: maramoh 
wring: maramoh 
bind: mangabeʔ 
fasten: mangabeʔ 
tie up: mangabeʔ 
enumerate: maetoŋ 
number: maetoŋ 
tally: maetoŋ 
ocean: lauiʔ 
evil: jaeʔ 
rot: busuaʔ 
filthy: kumuah 
soiled: kumuah 
blunt: buntu 
damp: busah 
right side: suoʔ 
at: di 
inside: di dalam 
