all: aawïnunu | ɑwənunu 
arm: faayu 
ashes: waraaga | warɑga 
bark: yaraana | yarɑna 
belly: avgwa | aβgwa 
big: yaini\ | yainiʔ 
bird: inko 
bite: araavanta | arɑβanta 
black: paare\ | pɑteʔ 
blood: taagi | tagi	tɑgi 
bone: yaanga | yanggai	yaŋgɑi 
breast: aamïgo | am3go	ɑməgo 
burn: tava daigerieri 
claw: avevana | aβeβana 
cloud: aavgwa | ɑβgwa 
cold: yamga(va) | yamga	yamgaβa 
come: navwiaarï | navwiar3	naβwiɑrə 
die: navaago | navago	naβɑgo 
dog: tayo 
drink: inaaga namdï | inaga namd3	inɑga n-amdə 
dry: yaayï\ | yɑyəʔ 
ear: araa | ara	arɑ 
earth: warïgwarï | warəgwarə 
eat: n-amda\ | n-amdaʔ 
egg: m.ge | mge 
eye: aagwaai | agwai	ɑgwɑi 
fat (n.): aawa/m.ge 
feather: fave\ | ɸaβeʔ 
fire: ta(vï\) | ta	taβəʔ 
fish: pe\ | pe7	peʔ 
fly (v.): aagana\ 
full: maagwa\ | magwa7	mɑgwaʔ 
give: namaandï\ | namɑndəʔ 
good: naagoge\ | nɑgogeʔ 
green: wanaagwei | wanɑgwei 
hair: ndaa(vï\) | ndɑ	ndɑβəʔ 
head: mïnggaaya | məŋgɑya 
hear: ara andegï | ara andeg3	ara andegə 
heart: fawa 
horn: kampianga | kampianga	kampiaŋa 
I: n.na/ndo | ndo	nna 
kill: naav-o\ | nɑβ-oʔ 
knee: wamgaya 
know: namdïnogara | namdənogara 
leaf: (i)wana | iwana	wana 
leg: avga 
lie: ewegï\ | ewegə 
liver: bemgai 
long: toyaavegi | toyɑβegi 
louse: ye 
man: avo/waako | avo	aβo 
many: taavïraavi | tɑβərɑβi 
meat: mgawe\ 
moon: aamnggo | ɑmŋgo 
mountain: aai | ai	ɑi 
mouth: maaga | mɑga 
name: ntaga 
neck: abdï | abdə 
new: sanko\ | sanko7	čankoʔ 
night: mvovïna | mwov3na	mβoβəna 
nose: hamï | ham3	hamə 
not: fe- | ɸe- 
one: fonu\ | fonu7	fonu’	ɸonuʔ 
person: avo | avo	aβo 
rain: m.na | nma 
red: taarai\ | tɑraiʔ 
road: faai | fai 
root: avakï | aβakə 
round: mïmagaai | məmagɑi 
sand: inamne 
say: dï-nandï\ | inamne 
seed: (iga)avgwe | aβgwe	iga aβgwe 
see: woamdegu 
sit: omaagï\ | omɑgə 
skin: yara(na) | yara	yarana 
sleep: ya wamdï | ya wamdə 
small: saaigwa\ | čɑigwaʔ 
smoke: umaga(vï\) | umaga	umagaβəʔ 
stand: erewagu 
star: anaaga | anaga	anɑga 
stone: andaga 
sun: avgwo | avgwo	aβgwo 
swim: avaamdï\ | aβɑmdəʔ 
tail: yasinkava | yɑinkaβa 
that: aai | ɑi 
this: dade 
thou: ndï/ogï | nd3	ndə	og3	ogə 
tongue: aabgwa/aavwia | abgwa	avwia	ɑbgwa	ɑβwia 
tooth: maaga | maga	mɑga 
tree: iga\ | iga7 
two: faaina | faaina	faina	ɸɑina 
walk: nawaarï | nawɑrə 
warm: tanne\ 
water: inaaga | inaga	inɑga 
we (incl.): naaitone 
what: namape 
white: avwa | aβwa 
who: ntaankoga | ntɑnkoga 
woman: abaagi | abɑgi 
yellow: meraai | merɑi 
every: ɑwənunu 
ash: warɑga 
abdomen: aβgwa 
bigness: yainiʔ 
large: yainiʔ 
breasts: am3go	ɑməgo 
nail: aβeβana 
talon: aβeβana 
come from: navwiar3	naβwiɑrə 
be dead: navago	naβɑgo 
dead: navago	naβɑgo 
ground: warəgwarə 
land: warəgwarə 
soil: warəgwarə 
fly: ɑganaʔ 
fly v.: ɑganaʔ 
1 sg.: ndo	nna 
be knowledgeable: namdənogara 
lie down: ewegə 
head louse: ye 
male: aβo	wɑko 
much: tɑβərɑβi 
multiple: tɑβərɑβi 
several: tɑβərɑβi 
hill: ai	ɑi 
title: ntaga 
nighttime: mwov3na	mβoβəna 
adulterous: fonu7	fonu’	ɸonuʔ 
single: fonu7	fonu’	ɸonuʔ 
the: fonu7	fonu’	ɸonuʔ 
unprincipled: fonu7	fonu’	ɸonuʔ 
human: avo	aβo 
human being: avo	aβo 
rainy weather: nma 
path: fai 
route: fai 
hide: yara	yarana 
little: čɑigwaʔ 
smallness: čɑigwaʔ 
rock: andaga 
2 sg: nd3	ndə	og3	ogə 
you: nd3	ndə	og3	ogə 
grind: faaina	faina	ɸɑina 
go: nawɑrə 
1 pl. inc.: naitone	nɑitone 
we: naitone	nɑitone 
we₁: naitone	nɑitone 
whiteness: aβwa 
who?: ntɑnkoga 
female: abɑgi 
