all: -mínǯó	mínǯó 
every: -mínǯó	mínǯó 
ash: ?náː	fídaːdò 
ashes: ?náː	fídaːdò 
bark: líhè 
abdomen: hàt	ɦʌd 
belly: hàt	ɦʌd 
big: -bá	bbá 
bigness: -bá	bbá 
large: -bá	bbá 
bird: gídwí	ɗíːɗúò 
bite: áːd	ʌwiːd 
black: -bɔgɔd	bɔ̀gɔ́t 
blood: obor	ɔːbɔ̀r	ɔ́bɔ̀r 
bone: ku*nonu	kunono	kúnóːnù 
breast: fabo	faːbò	fáːbó 
breasts: fabo	faːbò	fáːbó 
claw: karɔ̀mò 
nail: karɔ̀mò 
talon: karɔ̀mò 
cloud: róriːggeː 
cold: kʌːsúk	ràwát 
come: suqáai	suwak	sák	súwák 
come from: suqáai	suwak	sák	súwák 
be dead: mat	maːt	muːt 
dead: mat	maːt	muːt 
die: mat	maːt	muːt 
dog: fuga	fugà	ɸúgá 
drink: suwa	suːk	súwà 
dry: kɛːǯìt 
ear: sumamu	sumaːmo	súmáːmù 
eat: tuːk	tìyá	túwà	čâːm 
egg: issɔ	ɗíssó 
eye: irin	irinî	írín	íríɲ 
feather: álèː	ʔalɛ 
fire: kewi	kèwí	kɛ̀wíː	kʌwî 
fish: bogoso	bɔːgɔ̀sò	bɔ̀gɔ̀sɔ́ 
foot: sin	sîn 
give: bár	ɦiːná 
good: mɗé 
green: ròǯét 
hair: álèː	ʔalɛ 
hand: foso	fɔso	ɸɔ́sɔ́ 
left hand: foso	fɔso	ɸɔ́sɔ́ 
right: foso	fɔso	ɸɔ́sɔ́ 
head: kač	kàč 
hear: jige	ǯìgè	ǯîgɛ́wɔ̀	ʒ̬ìgè 
heart: kɔ̀rlɔ̀ 
horn: gebi	géːbí	gɛːbí 
1 sg.: nde	nd~e	ndɛ́ 
I: nde	nd~e	ndɛ́ 
kill: diː	dúːk 
knee: gip	gìb	gìp 
be knowledgeable: yaː	yɛat 
know: yaː	yɛat 
leaf: b"eriyo	berrîo	ɓéríyò 
liver: sat	saːt	sât 
long: -sʌgʌr	sàgár 
head louse: idedi 
louse: idedi 
male: nǯɔ̀gɔ̀rɔ́k 
man: nj~o	nǯoː	nǯóː 
many: nàmát	ɦinʌmʌt 
much: nàmát	ɦinʌmʌt 
multiple: nàmát	ɦinʌmʌt 
several: nàmát	ɦinʌmʌt 
moon: tirî	tírí 
hill: ɔːǯɔːmó 
mountain: ɔːǯɔːmó 
mouth: bàŋ	bʌŋ	nàŋ 
name: sami	semmî	sàmì 
title: sami	semmî	sàmì 
neck: wíːrì	wîrì 
new: rɛ̀wèt 
night: ded"em	deddem	dèdém	dèɗém 
nighttime: ded"em	deddem	dèdém	dèɗém 
nose: idanu	ídanò	ídáːnù 
not: ù	ɗò	ɗù 
adulterous: fini	fìnét	fíní	ʔfînì 
one: fini	fìnét	fíní	ʔfînì 
single: fini	fìnét	fíní	ʔfînì 
that: fini	fìnét	fíní	ʔfînì 
the: fini	fìnét	fíní	ʔfînì 
unprincipled: fini	fìnét	fíní	ʔfînì 
human: nj~o	nǯoː	nǯóː 
human being: nj~o	nǯoː	nǯóː 
person: nj~o	nǯoː	nǯóː 
rain: ɓok 
rainy weather: ɓok 
red: -reɲet	rènét	rɛ̀ɲɛ́t 
path: bodol 
road: bodol 
route: bodol 
root: búk 
sand: sínɔ̀k	síɲɔ́k	sîɲo 
say: kawa	káː 
see: om	ummá	ʔoːm	ʔób 
seed: busün 
sit: wirí	wírâi	wírì 
hide: jit	ǯit	ǯìt 
skin: jit	ǯit	ǯìt 
sleep: hèyít	hìyáːt	hɛʔít 
little: -ram	rám 
small: -ram	rám 
smallness: -ram	rám 
smoke: iǯa 
star: sisuwa	sísüwa	síːsúwá 
rock: wi	wíː	wîː 
stone: wi	wíː	wîː 
sun: fat	faːat	fàt	fàːt 
swim: ʌɲà	ʔánà	ʔáɲà 
tail: iɲɛwî 
this: gaŋ	gʌŋinne 
2 sg: kám	kʌm 
thou: kám	kʌm 
you: kám	kʌm 
tongue: lisi	lísí	ʔlîsî 
tooth: siNaNu	sìŋaŋu	sìŋàŋù	sìŋáaŋɔ̀ 
tree: aduwo 
grind: sir	sìːr	sī́r 
two: sir	sìːr	sī́r 
hot: -kerit	kèrít 
warm: -kerit	kèrít 
water: ame	aːm	àːmé 
what: mî	mîː 
white: -fèrèt	fɛ́rɛ́t 
whiteness: -fèrèt	fɛ́rɛ́t 
who: gin	giːn	mìn	ŋatu 
who?: gin	giːn	mìn	ŋatu 
female: luk	lu̩k	lùk 
woman: luk	lu̩k	lùk 
dull: kɔrlò	kɔ̀rlɔ̀ 
heavy: kɔrlò	kɔ̀rlɔ̀ 
serious: kɔrlò	kɔ̀rlɔ̀ 
salt: úlɔ́ːlɔ̀ 
snake: kakɔ̀	káːkó	káːkóː 
thin: -sɛ́yɛ́kèn 
wind: kùsúk 
