all: bula 
ashes: ts\iakn | tsʼiakn 
bark: orkn 
belly: yiːnu 
big: yatsiz 
bird: kaɓ 
bite: wotsəmba 
black: ts\ahinz | tsʼahinz 
blood: yɛřbm | yErbm~	yɛřbm 
bone: usus 
breast: ti\am | tiam	tiʼam 
burn: taso 
claw: šiškɪn | šiškɪn 
cloud: doʔu 
cold: šow | šow 
come: yəgo | y3go	yəgo 
die: šubo | Subo	šubo 
dog: ki\anu | kianu	kiʼanu 
drink: boɓkesk | boɓkesk	wobkesk 
dry: kola 
ear: hai(s) | hai	hais 
eat: mma 
egg: mɔla 
eye: ap˗u | ap-u	apu 
father: babe 
fat (n.): kow 
fire: tamu 
fish: aša | aSa	aša 
fly (n.): utsi 
foot: a\šu | aʼšu 
give: atsn 
good: šiška | šiška 
grass: šaš 
hair: tsitsu(s) | tsitsu	tsitsus 
hand: kuču(s) | kuCu	kuCus	kuču	kučus 
head: mot 
hear: sisne 
heart: šunus | šunus 
horn: uša | uSa	uša 
house: i 
I: na 
kill: ušo | ušo 
knee: gumtu 
know: t\uso | tʼuso 
leaf: ai 
liver: bufu 
long: šadniz | šadniz 
louse: č\uč\u | C"uC"u 
man: iab 
many: dofa 
meat: ašku 
moon: atsɪn 
mountain: mai 
mouth: ɛd(us) | ɛd	ɛdus 
name: sum(u) | sum	sumu 
neck: feli 
new: k\anu | k"anu	kʼanu 
night: gʷata | gw~ata	gʷata 
one: isn | isin	isn 
other: bəda 
rain: iru 
red: turbm 
road: buřun | burun 
root: zɪga(s) | zɪga	zɪgas 
sand: bolu 
say: maho 
seed: yaru 
see: semo 
sit: aša | aša 
skin: fatu 
sleep: soka 
small: č\oant\ai | čʼoantʼai 
smoke: čuɓu | čuɓu 
snake: šoš | šoš 
stand: aškio 
star: šeʲ̌a | SeCa	SeiCa	šeⁱča 
stone: nʲelu | 5elu	nelu	nʲelu 
sun: šaž | SaZ	šaž 
swim: wokn 
tail: šokn | šokn 
thin: naču | naču 
this: yes 
thou: ne 
three: kadu 
tongue: yalb 
tooth: aču | aCu	aču 
tree: inčus | inC~us 
two: tagn | tagen	tagn 
walk: tego 
warm: k\etsua | kʼetsua 
water: hai 
we: na\toknu | natoknu 
wet: kolua 
what: iřa | iřa	yira 
what: yira | iřa	yira 
white: gotnz 
who: ɪtia 
woman: moškn | moškn 
every: bula 
ash: tsʼiakn 
abdomen: yiːnu 
bigness: yatsiz 
large: yatsiz 
breasts: tiam	tiʼam 
nail: šiškɪn 
talon: šiškɪn 
come from: y3go	yəgo 
be dead: Subo	šubo 
dead: Subo	šubo 
left hand: kuCu	kuCus	kuču	kučus 
right: kuCu	kuCus	kuču	kučus 
1 sg.: na 
be knowledgeable: tʼuso 
head louse: C"uC"u 
male: iab 
much: dofa 
multiple: dofa 
several: dofa 
hill: mai 
title: sum	sumu 
nighttime: gw~ata	gʷata 
nose: sinus 
adulterous: isin	isn 
single: isin	isn 
that: isin	isn 
the: isin	isn 
unprincipled: isin	isn 
human: iab 
human being: iab 
person: iab 
rainy weather: iru 
path: burun 
route: burun 
hide: fatu 
little: čʼoantʼai 
smallness: čʼoantʼai 
rock: 5elu	nelu	nʲelu 
2 sg: ne 
you: ne 
grind: tagen	tagn 
hot: kʼetsua 
1 pl. inc.: natoknu 
we₁: natoknu 
whiteness: gotnz 
who?: ɪtia 
female: moškn 
