all: -gɛdiːd	tɛ=gıdid 
every: -gɛdiːd	tɛ=gıdid 
ash: hıbıd	hɪbɪd 
ashes: hıbıd	hɪbɪd 
bark: kɛrɛf	kʌrʌf 
abdomen: tawa 
belly: tawa 
big: dʊb-ku	dʋb-ku 
bigness: dʊb-ku	dʋb-ku 
large: dʊb-ku	dʋb-ku 
bird: kɛrba	kʌrba 
bite: dəs-to	dɛs-to 
black: sur-ku	sǔr-ku 
blood: kito	kɪto 
bone: kEti	kEtin	kə-ti	kɛtiː	kɛtiːn 
breast: kina	kɪna 
breasts: kina	kɪna 
burn: nə̄m-ˈə̄i̯-tò 
burn tr.: nə̄m-ˈə̄i̯-tò 
claw: šokna 
nail: šokna 
talon: šokna 
cloud: nasob	ǯiːm 
cold: kəlli	kɛli 
come: wo	wɔə̯-t̪ʰo	wɔː-to 
come from: wo	wɔə̯-t̪ʰo	wɔː-to 
be dead: di	diː-to	diːto 
dead: di	diː-to	diːto 
die: di	diː-to	diːto 
dog: wEs	wəs	wɛs 
drink: li	liː-to 
dry: diʼseː-gu	dısˈɛ-gu 
ear: tus	tʊs	tʋs 
earth: lʉg-ʉd 
ground: lʉg-ʉd 
land: lʉg-ʉd 
soil: lʉg-ʉd 
eat: kal-	kɛllo	kʌl-du 
egg: war-i	wari 
eye: no	nò	nɔ 
fat: kasa 
fat n.: kasa 
grease: kasa 
lubricant: kasa 
oil: kasa 
feather: sɛβi 
fire: Sita	ši-ta	šita 
fish: asa	aːsá 
foot: bəla-tə̀gına	šokna 
give: ni-to	niː- 
good: haggi-	hāgē-ku 
green: čılmāŋ-kū 
hair: sɛbiː	sɛβi 
hand: at	áːt 
left hand: at	áːt 
right: at	áːt 
head: kel-a	keːla 
hear: EsElo	ɛʼsɛllo	ɨsˈɛl-lu 
heart: asıma	ɛsʼma 
horn: keli	keːl-i	keːli 
1 sg.: ag 
I: ag 
kill: siː-	siː-to 
be knowledgeable: ısei̯-to	ɨssaːy- 
know: ısei̯-to	ɨssaːy- 
leaf: tifini	tıfinī	tɪʼfɪni 
lie: təф-to 
lie down: təф-to 
liver: kıbi̯dɛt	tile	tɪlle 
long: ngir-	ŋgir-ku 
head louse: Siti	šiti 
louse: Siti	šiti 
male: ko	ku 
man: kotaːda	ku	kɔ-ti 
many: muʼsaːk-	məsaː-ku 
much: muʼsaːk-	məsaː-ku 
multiple: muʼsaːk-	məsaː-ku 
several: muʼsaːk-	məsaː-ku 
flesh: nɔ́ː-ta 
meat: nɔ́ː-ta 
moon: feːta 
hill: kofa	koːfa 
mountain: kofa	koːfa 
mouth: awɔlo	aʷlo 
name: ada	aːd-a	aːda 
title: ada	aːd-a	aːda 
neck: habe	hʌbe 
new: wEr	wɔr-ku	wɛr- 
night: kiS3ne	kiS7~ne	kišⁱʔne	kıšiŋa 
nighttime: kiS3ne	kiS7~ne	kišⁱʔne	kıšiŋa 
nose: dEmo	dəmmo	dɛmmo 
not: ka-	ma- 
adulterous: dokku	doku	dɔkku 
one: dokku	doku	dɔkku 
single: dokku	doku	dɔkku 
that: ay=te	te 
the: dokku	doku	dɔkku 
unprincipled: dokku	doku	dɔkku 
human: kotaːda	ku	kɔ-ti 
human being: kotaːda	ku	kɔ-ti 
person: kotaːda	ku	kɔ-ti 
rain: halá	haʼlaː 
rainy weather: halá	haʼlaː 
red: šol-ku	šɔl- 
path: kita 
road: kita 
route: kita 
root: tɛrb-i	tɛrba 
sand: lūgʋd	saːse 
say: man-	walay-	wələ-k 
see: lE	lat-	lɛt-to	lɛː- 
seed: terab	terap 
sit: ta-to	taː- 
hide: hadi	haːdi	hādˈī 
skin: hadi	haːdi	hādˈī 
sleep: nɔttɛy-	təβ-to	wal- 
little: šiːn-	šiːŋ-ku 
small: šiːn-	šiːŋ-ku 
smallness: šiːn-	šiːŋ-ku 
smoke: asuru	aʼsuro 
stand: ndolu 
star: hūwīnī	wini	wiːni 
rock: tana	taːna	t̪ana 
stone: tana	taːna	t̪ana 
sun: kos	koːs	kɔs	kʷəs 
swim: būŋˈɩ̄n-dū	bʊŋɛ 
tail: d̪awa	tawa 
this: yi	yiː 
2 sg: iNa	ıŋˈa	ɪŋa 
thou: iNa	ıŋˈa	ɪŋa 
you: iNa	ıŋˈa	ɪŋa 
tongue: haga	hage	hagge 
tooth: nihi	nīhī-tà 
tree: kEl	kel 
grind: Eriga	arriga	arˈi-ga	ɛriga 
two: Eriga	arriga	arˈi-ga	ɛriga 
go: ɛːl- 
walk: ɛːl- 
hot: daʼwuː-	hawˈu-gu 
warm: daʼwuː-	hawˈu-gu 
water: mba	mb~a	mʼbaː 
1 pl. inc.: aga	agga 
we: aga	agga 
we₁: aga	agga 
what: nda-nan	nʼdaːnan 
white: erˈɛŋ-ku	ɛʼrɛːn- 
whiteness: erˈɛŋ-ku	ɛʼrɛːn- 
who: naːnan	nā-nə̄n 
who?: naːnan	nā-nə̄n 
female: anɛn	anˈinna 
woman: anɛn	anˈinna 
yellow: kurkˈum 
distant: makk-	maː-ku 
far: makk-	maː-ku 
dull: dɨlu-ku 
heavy: dɨlu-ku 
serious: dɨlu-ku 
close: labi	lok- 
near: labi	lok- 
ner: labi	lok- 
salt: səndʌ 
short: kʷɨdʋr-ku 
snake: wɔso 
thin: waʼraːnɛ-	wərˈāːnē-gù 
wind: šımal 
earthworm: wəlˈi 
worm: wəlˈi 
year: aməd 
