all: d\ahan | dʼahan 
ashes: ben 
bark: medah 
belly: ur 
big: abur 
bird: čɨmbir | čɨmbir 
bite: xanin˗ | xanin- 
black: d\a | dʼa 
blood: d\ig | Tig	dig	dʼig 
bone: laf | l3f	laf 
breast: nahas | n3h3s	nahas 
burn: gub˗ 
claw: gofən 
cloud: dubbət 
cold: rufod\a | rufodʼa 
come: kale 
die: yumu | mu	yumu	yumut 
dog: kar | k3r	kar 
drink: d\əm | T3m	d3m	dʼəm 
dry: aŋgage 
ear: dogo 
eat: ħün˗ | ħün- 
egg: ukun 
eye: indo | indo	ind~o 
father: aba 
fat (n.): subaħ 
fire: dəb | d3b	d3p	dəb 
fish: yɛl | b3X3g	yEl	yɛl 
foot: luħ 
give: kɛn˗ | kɛn- 
good: ħagɛ 
grass: ħøs 
hair: tɨm 
hand: farro | f3ro	faro	farro 
head: mətaħ 
hear: dag˗ | d3g	dag	dag- 
heart: wəyam 
horn: gas | g3s	gas 
I: an(i) | 3ni	an	ani 
kill: gis˗ | gis- 
knee: ǯɨlɨb | Tilip	j3l3b	ǯɨlɨb 
know: gar˗ | gar- 
leaf: xadaħ | x3d3X	xadaX	xadaħ 
liver: ħalesi | X3lEsi	Xalesi	ħalesi 
long: dɛr 
louse: ɨnǯɨr | 3nj~3r	inTir 
man: mɛǯɛl | i5E5Et	mEjEl 
many: omar 
meat: ǯɨd 
moon: yɛya 
mountain: kur 
mouth: af 
name: məgəča | m3g3Ca	m3g3X3	məgəča 
neck: luxum 
new: ʕøsub | Xesub	Xosub	Xosup	ʕøsub 
night: iben | ibEn	iben 
one: kou | kou	kôw 
red: gudud 
road: ǯit | Tit	jit 
root: ħay 
sand: yoħanti 
say: dah˗ | dah- 
see: gɛr˗ | gEr	gɛr- 
sit: fɨddiso 
skin: maxɛl | m3xEl	maxEl	maxɛl 
sleep: udur˗ | udur- 
small: načul | načul 
smoke: um 
snake: tof 
stand: tolo˗s 
star: bakal | b3k3l	bakal 
stone: dəgaħ | d3g3X	d3gaX	dəgaħ 
sun: orra | or3	ora	orra 
tail: dub 
this: kən 
thou: ati | 3ti	ati 
three: seyyɛh 
tongue: harrəb | Xarap	har3b	harrəb 
tooth: ilko 
tree: gey | gEy	gey 
two: lama | lama	lʼáma 
walk: ir˗ 
warm: kullul 
water: bičeʔ | biCe7	biTE7	bičeʔ 
we: in(no) | in	ino 
what: amaħai 
white: daħnan 
who: aiyo 
woman: obori 
you: atin | 3ti	ati 
every: dʼahan 
ash: ben 
abdomen: ur 
bigness: abur 
large: abur 
breasts: n3h3s	nahas 
nail: gofən 
talon: gofən 
come from: kale 
be dead: mu	yumu	yumut 
dead: mu	yumu	yumut 
left hand: f3ro	faro	farro 
right: f3ro	faro	farro 
1 sg.: 3ni	an	ani 
be knowledgeable: gar- 
head louse: 3nj~3r	inTir 
male: mɛǯɛl 
much: omar 
multiple: omar 
several: omar 
hill: kur 
title: m3g3Ca	m3g3X3	məgəča 
nighttime: ibEn	iben 
nose: s3n	sən 
adulterous: kou	kôw 
single: kou	kôw 
that: kou	kôw 
the: kou	kôw 
unprincipled: kou	kôw 
human: i5E5Et	mEjEl 
human being: i5E5Et	mEjEl 
person: i5E5Et	mEjEl 
path: Tit	jit 
route: Tit	jit 
hide: m3xEl	maxEl	maxɛl 
little: načul 
smallness: načul 
rock: d3g3X	d3gaX	dəgaħ 
2 sg: 3ti	ati 
grind: lama	lʼáma 
hot: kullul 
1 pl. inc.: in	ino 
we₁: in	ino 
whiteness: daħnan 
who?: aiyo 
female: obori 
