all: bilaŋ | slapuq	səlapuq 
and: dait 
animal: [səsato] 
ashes: awuk | awu-awu 
back: buŋkak | boŋkor 
bad: Iəŋe | jahat 
bark: lendoŋ kayuʔ 
because: seŋaʔ 
belly: tian 
bird: kədit | kəmanukan 
bite: kekeʔ | gigit 
black: birəŋ | bidəŋ 
blood: daraʔ | daraq 
blow: pəpək-aŋ | niup 
bone: tolaŋ | tolaN	tolaŋ 
breast: susu 
breathe: əmbok | bərəmbok 
burn: sulu | nyədut 
child: anak 
cloud: awun-awun | ukəp 
cold: ñət | nyət 
come: datəŋ | dat3N	datəŋ 
correct: kənə 
count: ituŋ-aŋ | ŋərékéŋ 
cut: pəloŋ | məmələŋ 
die: mate | mate	matē 
dig: kali? | ŋəŋaliq 
dirty: gəmi | kotor 
dog: ačoŋ | basoN	basoŋ 
drink: inəm-an | Nin3m	ŋinəm 
dry: goro 
dull: koŋol | bərat | kudal 
dust: kləpuk | kələpuq 
ear: kəntok | k3ntok	kəntok 
earth: [bumi] 
egg: təloʔ | təloq 
empty: [kosoŋ] 
eye: matə | mat3	matə 
fall: ma | təriq 
far: ǰaoʔ | jaoq 
father: amaʔ | amaq 
fat (n.): Iəmu 
fear: takut 
few: sə-kədiʔ 
fingernail: tika-n 
fire: api 
fish: əmpaʔ | 3mp~aq	əmpaq 
five: limə | lime	limě 
float: ompal-ompal 
flower: kəmbaŋ 
fly (v.): kelep 
foot: nae 
forest: gawah 
four: əmpat | mpat	ěmpat	əmpat 
frog: lepaŋ 
fruit: buaʔ | buaq-buaqan 
full: pənoʔ 
give: ŋə-beŋ 
good: solah | bagus 
grass: pupaʔ | rəbu 
green: iǰo | ējo 
hair: bulu 
hand: imə | im3	imə 
head: ulu | otak 
hear: n-dəŋah | d3d3Nah	dədəŋah 
heavy: bərat 
he: niə | ie 
hit: ŋ-əmpuk | məmantok 
horn: soŋot 
how: brəmbe | bərəmbē	kembe 
husband: sə-mamə | səmamə 
I: aku | aku	tiang 
ice: [es] 
if: anden | lamun 
in: daləm | lēq daləm 
kill: mate-aŋ | nyəmatēq 
knee: kəkətut 
know: taoʔ | tauq 
lake: [təlagə] | səgarə anak 
large: bəleʔ | beleq	bəlēq 
laugh: ŋə-ləleʔ | kəréréq 
leaf: daun | gedeN	gédéŋ 
left: kiri 
leg: nae 
lie: ŋə-rəba? | tindok 
live: irup | idup 
liver: ate | ate	atē 
long: belo | bēlo 
louse: gutu 
man: mamə | manusə	tau 
many: loeʔ 
meat: эmpaʔ | əmpaq 
moon: bulan 
mother: inaʔ | inaq 
mountain: gunuŋ 
mouth: biwih 
name: aran 
near: rapət 
neck: bəloŋ 
new: baru 
night: kэləm | mal3m	maləm 
nose: iruŋ | iduN	iduŋ 
old: toaʔ 
one: səkek | %s3keq	sai	sekeq	səkēq	ěsa 
person: dəŋan | manusə	tau 
play: bə-kədek 
pull: awek 
push: soroŋ 
rain: uǰan | ujan 
red: abaŋ 
right: kanan | im3	imə | kawan 
river: kokoʔ 
road: laŋan | laNan	laŋan 
root: akah 
rope: tali | tətali 
rotten: loas | bais 
round: bolət 
rub: osok 
salt: siə 
sand: gəres | biras 
say: bər-uni | muni | biras 
sea: [səgarə] 
seed: ampar 
sew: ñ-ǰait | bəjait 
sharp: məraŋ | tajəp 
short: dendeʔ | kontēq 
sing: ñañian 
sit: tokol 
skin: lendoŋ | lend~oN	léndoŋ 
sky: laŋit 
sleep: tendoʔ | tidə..	tindok 
small: kode(ʔ) | kodēq 
smell: ñiruk (siruk) | siduk 
smoke: asəp | pəndət 
smooth: alus 
snake: ulah 
some: pirə 
spit: tiǰuʔ | bətusiq 
split: ŋə-bəlah | nyigar 
stab: galah | bəgalah 
stand: ŋ-añǰəŋ | ŋanjəŋ 
star: bintaŋ | bintaŋ	bint~aN 
stick: tuñǰaŋ | pēmpaŋ 
suck: sərut | ŋəmot 
sun: ǰəlo 
tail: eloŋ | ēloŋ 
they: niə | iə padə 
thick: təbəl 
think: aŋən-aŋən | mikir 
thin: tipis 
thou: kamu | ant~3	antə	kamu	side 
thou: kamu (səlapuʔ) | ant~3	antə	kamu	side 
three: təlu | telu	tělu	təlu 
throw: plewas | ŋəladək 
tie: naliʔ (tali-ʔ) | nənaliq 
tongue: əlaʔ | elaq 
tooth: gigi 
tree: lolon | kayuq 
turn: (badiŋ) 
two: duə | du3	due	duě	duə 
vomit: utak | ŋutaq 
warm: panas 
we: itə | it3	ite	itə 
wet: basaʔ | basaq 
what: apə | ape	apə 
when: piran 
which: əmbe 
white: putiʔ | putiq 
who: sai 
why: kembeʔ 
wide: goar | galuh 
wife: sə-ninə | səninə 
wind: aŋin 
wing: kletrk | kəléték 
woman: ninə 
worm: loŋə 
wrong: kə-salaʔ-an 
year: taun 
yellow: kuniŋ | koniŋ 
every: slapuq	səlapuq 
ash: awu-awu 
abdomen: tian 
big: beleq	bəlēq 
bigness: beleq	bəlēq 
breasts: susu 
burn tr.: nyədut 
come from: dat3N	datəŋ 
be dead: mate	matē 
dead: mate	matē 
eat: maŋan 
feather: bulu 
fly: kélép 
fly v.: kélép 
left hand: im3	imə 
1 sg.: aku	tiang 
be knowledgeable: tauq 
lie down: tindok 
head louse: gutu 
male: mamə 
title: aran 
nighttime: mal3m	maləm 
not: ndeq 
adulterous: %s3keq	sai	sekeq	səkēq	ěsa 
single: %s3keq	sai	sekeq	səkēq	ěsa 
that: no	sino 
the: %s3keq	sai	sekeq	səkēq	ěsa 
unprincipled: %s3keq	sai	sekeq	səkēq	ěsa 
human: manusə	tau 
human being: manusə	tau 
rainy weather: ujan 
path: laNan	laŋan 
route: laNan	laŋan 
see: g3gitaq	gəgitaq 
hide: lend~oN	léndoŋ 
little: kodēq 
smallness: kodēq 
rock: batu 
stone: batu 
swim: ŋonoŋ 
this: ni	sinē 
2 sg: ant~3	antə	kamu	side 
you: ant~3	antə	kamu	side 
grind: du3	due	duě	duə 
go: lampaq 
walk: lampaq 
hot: panas 
water: aiq 
1 pl. inc.: it3	ite	itə 
we₁: it3	ite	itə 
whiteness: putiq 
who?: sai 
female: ninə 
distant: jaoq 
serious: bərat 
close: rapət 
ner: rapət 
earthworm: loŋə 
3 sg.: ie 
she: ie 
2 pl.: antə səlap 
ye: antə səlap 
you all: antə səlap 
3 pl.: iə padə 
here: leq te 
there: leq to 
where: leq mbe	lēq əmbē 
where?: leq mbe	lēq əmbē 
when?: piran 
how?: bərəmbē	kembe 
other: lain 
broad: galuh 
wideness: galuh 
fat: ləmu 
narrow: kutiq 
principal wife: səninə 
his mother: inaq 
my mother: inaq 
his father: amaq 
my father: amaq 
woods: gawah 
branch: pēmpaŋ 
cord: tətali 
flesh: əmpaq 
grease: ləmu 
gut: baduk 
guts: baduk 
insides: baduk 
intestine: baduk 
intestines: baduk 
breath: bərəmbok 
laughter: kəréréq 
cogitate: mikir 
reflect: mikir 
sniff: siduk 
afraid: takut 
be afraid: takut 
fright: takut 
alive: idup 
be alive: idup 
life: idup 
living: idup 
hunt: nyəran 
beat: məmantok 
strike: məmantok 
hack: məmələŋ 
cut open: nyigar 
pierce: bəgalah 
scratch: ŋəŋaok 
drop: təriq 
grasp: ŋəntiq 
hold: ŋəntiq 
hold in arm: ŋəntiq 
squeeze: mijət 
wring: mijət 
bind: nənaliq 
fasten: nənaliq 
tie up: nənaliq 
enumerate: ŋərékéŋ 
number: ŋərékéŋ 
tally: ŋərékéŋ 
flow: ŋélék 
ocean: səgarə 
sea: səgarə 
fog: awun-awun 
evil: jahat 
rot: bais 
filthy: kotor 
soiled: kotor 
blunt: kudal 
damp: basaq 
right side: kawan 
at: lēq 
inside: lēq daləm 
