all: myɛ̃́	mṹɔ̃́ 
every: myɛ̃́	mṹɔ̃́ 
ash: ciɔ̃̄yɔ̃̄	ciɔ̃̄ʔɔ̃̄ 
ashes: ciɔ̃̄yɔ̃̄	ciɔ̃̄ʔɔ̃̄ 
abdomen: fityɛ̃̄gélē	fítyɛ̃̄nɛ̀ 
belly: fityɛ̃̄gélē	fítyɛ̃̄nɛ̀ 
big: cɛ́rɛ́ 
bigness: cɛ́rɛ́ 
large: cɛ́rɛ́ 
bird: séyiɛ̃̄nɛ	séyĩ̄ɛgélē 
bite: nɔ̃̄	nɔ̃̄gū 
black: wuɔ	wúo	wɔ́ɔ 
blood: sìsã̩ 
bone: kātyèlìyé	kātyēlīgè 
breast: yīrēlē 
breasts: yīrēlē 
claw: kādyirè	kādyĩgè 
nail: kādyirè	kādyĩgè 
talon: kādyirè	kādyĩgè 
cloud: fàfāʔā	fàāyā 
cold: ɲĩ́gí	ɲĩ̄gī 
come: pã̄	pã̄a 
come from: pã̄	pã̄a 
be dead: kùu	kúu 
dead: kùu	kúu 
die: kùu	kúu 
dog: pɔ̃̄bélē	pɔ̃̄ɔ̃ 
drink: gbā	gbɔ̃̄ 
dry: wāʔā	wāʔārī 
ear: nuwɛʼɛgɛ	nūwɛ̄ɛyɛ̄ 
eat: lìi	líi 
egg: cɛ̃̄gélē	cɛ̃̄nē 
eye: ɲɔ̃pīlè	ɲɔ̃̄pīgélē 
feather: siígē	siíré 
fire: kàsɔ̄ʔɔ́	nāʔãʏ̈ 
fish: fyá	fyábélē 
fly: yìrí	yìrīgí 
fly v.: yìrí	yìrīgí 
foot: tɔ̄lɔ̄gɔ̄	tɔ̄lɔ̄yɔ̄ 
full: ɲĩ̄	ɲĩ̄di 
give: kã̄a	kã̄ʔã̄ 
good: ɲɔ̃̄ɔ̃	ɲɔ̃̄ʔɔ̃̄ 
hair: šiígē	šiírē 
hand: kɛ̄ yɛ̀	kɛ̄ʔɛ̀ 
left hand: kɛ̄ yɛ̀	kɛ̄ʔɛ̀ 
right: kɛ̄ yɛ̀	kɛ̄ʔɛ̀ 
head: ɲũʏ̈gò	ɲũʏ̈yò 
hear: lóʔó	lúrú 
horn: ɲɛ̃̄gélē	ɲɛ̄nɛ̄ 
1 sg.: mìi 
I: mìi 
kill: kpó	kúu 
be knowledgeable: cɛ̃́	cɛ̃́dí 
know: cɛ̃́	cɛ̃́dí 
leaf: wɛ̄gɛ̄	wɛ̄rɛ̄ 
lie: sìnɛ̄	sīnɛ̄ 
lie down: sìnɛ̄	sīnɛ̄ 
long: tɔ̃̄nɔ̃̄	tɔ̃̄nɔ̃̄ʔɔ̃̄ 
male: nãʏ̈bēlē	nãʏ̈wãʏ̈ 
man: šɔ̃ɔ	šɛ̃ʏ̈ɛnɛ̃̄ 
many: sáa 
much: sáa 
multiple: sáa 
several: sáa 
moon: yēgè	yēyē	yēʔè 
hill: tūpũ̄nɔ̃́	ɲã̄bēlīgē 
mountain: tūpũ̄nɔ̃́	ɲã̄bēlīgē 
mouth: ɲɔ̃ʼɔ̃ʔɔ̃	ɲɔ̃ʼɔ̃̄ɲɔ̃̄ 
name: mɛ̃́ɛ̃yɛ̃́	mɛ̃́ʔɛ̃́ 
title: mɛ̃́ɛ̃yɛ̃́	mɛ̃́ʔɛ̃́ 
new: fɔ̃	fɔ̃́dú 
night: yébiliyè	yébīlīgè 
nighttime: yébiliyè	yébīlīgè 
nose: fínakã́anã	fínákã́agélē 
not: dā … yɛ̄ʼɛ̄ 
adulterous: ǹyã̄ 
one: ǹyã̄ 
single: ǹyã̄ 
that: gèe	kēe 
the: ǹyã̄ 
unprincipled: ǹyã̄ 
human: šɔ̃ɔ	šɛ̃ʏ̈ɛnɛ̃̄ 
human being: šɔ̃ɔ	šɛ̃ʏ̈ɛnɛ̃̄ 
person: šɔ̃ɔ	šɛ̃ʏ̈ɛnɛ̃̄ 
rain: žàyá	žàʔá 
rainy weather: žàyá	žàʔá 
red: ɲã́nã́ʔã́	ɲã̄nã̄ʔã́ 
root: dēnĩʏ̈gè	dēnĩʏ̈rè 
round: kóróró 
sand: táníɲɔ̃ʏ̈ɔ	tã́ɲɔ̃ʏ̈ɔ 
say: yō	yũ̄ 
see: ɲã̄ã	ɲã̄ʔã̄ 
sit: tɛ̰́ɛ̃ 
hide: sɛ̄līyɛ̀	sɛ̄lɪ̄gɛ̀ 
skin: sɛ̄līyɛ̀	sɛ̄lɪ̄gɛ̀ 
sleep: ŋúnɔ̪̃ 
little: cɛ́rɛ́	cɛ́rɛ́ʔɛ́ 
small: cɛ́rɛ́	cɛ́rɛ́ʔɛ́ 
smallness: cɛ́rɛ́	cɛ́rɛ́ʔɛ́ 
smoke: wíríge	wíríye 
star: wɔ̄rīgélē	wɔ̄rīlɔ̀ 
rock: fárábīgélē	fárábīlé 
stone: fárábīgélē	fárábīlé 
sun: tyã̄gà 
tail: nagele	nãga	nã̄	nã̄yã̄ 
this: lèe 
2 sg: mɔ̄ 
thou: mɔ̄ 
you: mɔ̄ 
tongue: yìlè	yīgélē 
tooth: gãsãʏ̈gēlē̄	gǎsãʏ̈nà 
grind: šɛ̃̄ 
two: šɛ̃̄ 
go: tã́ari	tã́ʔã́ 
walk: tã́ari	tã́ʔã́ 
water: lɔ̀ʔɔ̀ 
white: fínígé	fítígé 
whiteness: fínígé	fítígé 
who: wìí 
who?: wìí 
female: tyɛ̄bélē	tyɛ̄līwɛ̄ 
woman: tyɛ̄bélē	tyɛ̄līwɛ̄ 
distant: léelí 
far: léelí 
dull: lúgórú	túgó 
heavy: lúgórú	túgó 
serious: lúgórú	túgó 
close: tã̄ãnã̄ 
near: tã̄ãnã̄ 
ner: tã̄ãnã̄ 
salt: sōlōmɔ̃ʏ̈ 
short: kpērē	kpērēʔē 
snake: wɔ̀bìgɔ̀	wɔ̀bìyɔ̀ 
year: yīɛgélé	yīɛlɛ̄	yɛ̄ʔɛ̄lɛ̄ 
