all: ʔuma | atoa	uma	ʻātoa 
and: ma 
animal: manu 
ashes: lefulefu | lefu	lefulefu 
back: papā-tua 
bad: leaŋa 
bark: paʔu | pa7u 
because: ʔauā 
belly: manava | laualo	manava	puimanava 
bird: manu-lele | manu	manulele 
bite: ū | ati	u	ʻati 
black: uliuli | uli	uliuli 
blood: toto | pala	toto 
blow: aŋi 
bone: ivi | ivi	panaivi	ponaivi 
breast: susu | fata	susu 
breathe: mānava 
burn: faʔa-mū | mu | mu	tafu 
child: tama 
cloud: ao 
cold: mālūlū | malulu	maʻalili 
come: sau | mai	sau	ō mai 
correct: saʔo 
count: fai-tau | faitau 
cut: tipi | faʻa-mutu 
die: oti | malaia	maliu	mate	oti 
dig: ʔeli | ʻeli	ʻoso 
dirty: ʔeleʔele-a | ʻeleʻelea 
dog: maile | maile	uli	ʻulī 
drink: inu | inu	taute 
dry: maŋo | maNo	mago	matutu	maŋo 
dull: matatupa | mamafa 
dust: pefu | p|efu 
ear: taliŋa | taliNa	taliga	taliŋa 
earth: lau-ʔeleʔele | ele	pala 
empty: ātiŋi 
eye: mata | fofoNa	mata 
fall: lāpo | paʻū 
far: mamao 
father: tama | tamā 
fat (n.): ŋaʔo 
fear: fefe | fefe	mataʻu 
few: itiiti 
fingernail: maiʔuʔu 
fire: afi | afi	mu 
fish: iʔa | i7a	iʻa 
five: lima 
float: opeopia 
flower: fuŋa 
flow: tafe 
fly (v.): lele 
fog: puao 
foot: vae | a7ao	vae 
forest: vao 
four: fā | e fā	fa 
frog: [lane] 
fruit: fua 
full: tumu 
give: ʔave | aumai	avatu 
good: lelei 
grass: mutia 
green: lanu-mea-mata | lanumeamata 
guts: ŋāʔau | ŋāʻau 
hair: lau-ulu | lau ulu	laulu 
hand: lima | a7ao	lima 
head: ulu 
hear: faʔaloŋo | fa7aloNo	fa7alogo	faʻa-loŋo	laNona 
heart: fatu 
heavy: mamafa 
he: ia 
hit: sasa | tā 
horn: nifo | nifo	seu 
how: faʔapēfea | faʻapēfea 
hunt: tuli 
husband: tāne 
I: aʔu | a7u	aʻu	ita 
ice: [ʔaisa] 
if: peʔā | ʻa|na 
in: i totonu o | [i]totonu[o] 
kill: fasi-otì | fasi	fasioti	tāmate 
knee: tuli-vae | tulivae 
know: iloa | ilo-a	iloa	silafia 
lake: loto | lano 
large: tele | lapo7a	tele 
laugh: ʔata | ʻata 
leaf: lau | la7au	lau 
left: tau-aŋavale 
leg: vae 
lie: ta?oto | ta7atia	ta7oko	ta7oto	taliaŋa 
live: ola 
liver: ate | ate	veve 
long: ʔumi | loa	umi	ʻumi 
louse: ʔutu | utu	ʻutu 
man: tāne | taNata	tagata	taŋata 
many: tele | lasi	tele	to7atele 
meat: ʔaʔano | a7ano	anoNasi | ʻaʻano 
moon: māsina | masina	māsina 
mother: tinā 
mountain: mauŋa | mauNa	mauga 
mouth: ŋutu | gutu	muaNuta	ŋutu 
name: iŋoa | iNoa	igoa	iŋoa	suafa 
narrow: lau-itiiti | lauitiiti 
near: latalata 
neck: ua 
new: fou 
night: pō | po	pō 
nose: isu 
old: matua 
one: tasi | e tasi	tasi 
person: taŋata | taNata	tagata	taŋata 
play: taʔalo 
pull: toso 
push: tulei 
rain: ua | timu	timuNa 
red: mūmū | mumu	ʻula 
right: tau-matau | a7ao	lima 
river: vai-tafe 
road: ʔau-ala | ala	auala 
root: aʔa | a7a	aʻa 
rope: maea 
rotten: mafu | pala 
round: lā-potopoto | fa7ata7amilo	lapotopoto 
rub: mili 
salt: māsima 
sand: oneone 
say: fai | fai atu	tautala | oneone 
sea: sami 
seed: fatu | fatu	fuNafuNamatia 
sew: suai | suʻi 
sharp: maʔai | maʻai 
short: puʔupuʔu | puʻupuʻu 
sing: pese 
sit: nofo | nofo	saofa7i 
skin: paʔu | pa7u	paʻu 
sky: laŋi 
sleep: moe | moe	tofaNa 
small: Iaʔitiiti | itiiti	la7itiiti	la7ititi	lili7i 
smell: laŋona | soŋi 
smoke: asu | asu	ausa 
smooth: mole 
snake: ŋata 
snow: [kiona] 
some: nisi 
spit: anu 
split: isi 
stab: tui 
stand: tū | fa7atu	tu | one	oneone	tū 
star: fetū | fetu	fetū 
stick: toʔotoʔo | lālā 
straight: saʔo 
suck: susu 
sun: la 
tail: siʔusiʔu | i7u	iʻu	si7u	si7usi7u	siʻusiʻu 
they: lātou 
thick: mafia 
think: māfaufau 
thin: manifi 
thou: ʔoe | oulua	outou	ʻoe 
thou: ʔoutou | oulua	outou	ʻoe 
three: tolu | e tolu	tolu 
throw: toŋi 
tie: noa 
tongue: laulaufaiva | alelo	laulaufaiva 
tooth: nifo | nifo	nifu	oloa 
tree: lāʔau | la7au 
turn: fuli 
two: lua | e lua	lua 
vomit: puaʔi | puaʻi 
warm: vevela | māfanafana 
wet: susū 
what: ā | o le a	olea	ʻo le ā 
when: āfea | afea	anafea 
which: lēfea 
white: paʔepaʔe | pa7e	pa7epa7e	paʻepaʻe 
who: ai | oai	po7o ai	ʻo ai 
why: ʔai-se-ā 
wide: lau-tele | lautele 
wife: āvā 
wind: mataŋi | mat|aŋi 
wing: ʔapa-ʔau | ʻapaʻau 
woman: fafine 
worm: ʔanufe | ʻanufe 
wrong: sesē 
year: tausaŋa | tau|saŋa 
yellow: samasama | sama	samasama	sāmasama 
every: atoa	uma	ʻātoa 
ash: lefu	lefulefu 
abdomen: laualo	manava	puimanava 
big: lapo7a	tele 
bigness: lapo7a	tele 
breasts: fata	susu 
burn tr.: mu 
claw: maiu7u	mati7uti7u 
nail: maiu7u	mati7uti7u 
talon: maiu7u	mati7uti7u 
come from: mai	sau	ō mai 
be dead: malaia	maliu	mate	oti 
dead: malaia	maliu	mate	oti 
ground: ele	pala 
land: ele	pala 
soil: ele	pala 
eat: ai	fai7aiNa	tausami	ʻai 
egg: fua	fuāmoa 
feather: fulu	fulufulu 
fly: fiti	lele 
fly v.: fiti	lele 
left hand: a7ao	lima 
1 sg.: a7u	aʻu	ita 
be knowledgeable: ilo-a	iloa	silafia 
lie down: ta7atia	ta7oko	ta7oto	taliaŋa 
head louse: utu	ʻutu 
male: tamaloa	tane	tāne 
much: lasi	tele	to7atele 
multiple: lasi	tele	to7atele 
several: lasi	tele	to7atele 
flesh: a7ano	anoNasi 
hill: mauNa	mauga 
title: iNoa	igoa	iŋoa	suafa 
nighttime: po	pō 
not: le	le7i	leai 
adulterous: e tasi	tasi 
single: e tasi	tasi 
that: lea	lela	lena	le|na 
the: e tasi	tasi 
unprincipled: e tasi	tasi 
human: taNata	tagata	taŋata 
human being: taNata	tagata	taŋata 
rainy weather: timu	timuNa 
path: ala	auala 
route: ala	auala 
see: matamata	pupula	va7ai	vaʻai 
hide: pa7u	paʻu 
little: itiiti	la7itiiti	la7ititi	lili7i 
smallness: itiiti	la7itiiti	la7ititi	lili7i 
rock: ma7a	maʻa 
stone: ma7a	maʻa 
swim: a7au	fe7ausi	ʻaʻau 
this: lea	lenai	lenei 
2 sg: oulua	outou	ʻoe 
you: oulua	outou	ʻoe 
grind: e lua	lua 
go: saele	savali 
walk: saele	savali 
hot: māfanafana 
water: suasami	suavai	vai 
1 pl. inc.: matou	mātou	tatou	tātou 
we: matou	mātou	tatou	tātou 
we₁: matou	mātou	tatou	tātou 
whiteness: pa7e	pa7epa7e	paʻepaʻe 
who?: oai	po7o ai	ʻo ai 
female: fafine 
distant: mamao 
serious: mamafa 
close: lata 
near: lata 
ner: lata 
earthworm: ʻanufe 
2 pl.: ʻoutou 
ye: ʻoutou 
you all: ʻoutou 
3 pl.: lātou 
where: ʻo fea 
where?: ʻo fea 
when?: afea	anafea 
how?: faʻapēfea 
other: isi	ʻese 
broad: lautele 
wideness: lautele 
fat: ŋaʻo 
principal wife: āvā 
his mother: tinā 
my mother: tinā 
his father: tamā 
my father: tamā 
woods: vao 
branch: lālā 
cord: maea 
grease: ŋaʻo 
gut: ŋāʻau 
insides: ŋāʻau 
intestine: ŋāʻau 
intestines: ŋāʻau 
back: tua 
breath: mānava 
laughter: ʻata 
cogitate: māfaufau 
reflect: māfaufau 
sniff: soŋi 
afraid: fefe	mataʻu 
be afraid: fefe	mataʻu 
fright: fefe	mataʻu 
alive: ola 
be alive: ola 
life: ola 
living: ola 
beat: tā 
strike: tā 
hack: faʻa-mutu 
cut open: isi 
pierce: tui 
scratch: valu 
drop: paʻū 
grasp: ʻuʻu 
hold: ʻuʻu 
hold in arm: ʻuʻu 
squeeze: ʻoʻomi 
wring: ʻoʻomi 
bind: noa 
fasten: noa 
tie up: noa 
enumerate: faitau 
number: faitau 
tally: faitau 
ocean: sami 
blaze: mu	tafu 
evil: leaŋa 
rot: pala 
filthy: ʻeleʻelea 
soiled: ʻeleʻelea 
blunt: matatupa 
damp: susū 
right side: tau-matau 
inside: [i]totonu[o] 
