all: tāʔātoʔa | anaʻe	atoʻa	ta7ato7a 
and: ʔe | ma	ʻee 
animal: [ʔanimara] | manu 
ashes: rehu | eàrahow	rehu	rehu auahi 
back: tua | etoo	toa	tua	tue 
bad: ʔino | ʻino 
bark: paʔarāʔau | pa7a	paʻa	ʻiri 
because: no te mea ē | nō te mea 
belly: ʔōpū | eoboo	opu	ʻoopuu	ʻōpū 
bird: manu | manoo	manu 
bite: hohoni | hohoni	hōhoni	ʻaʻahu	ʻaʻati 
black: ʔereʔere | ere7ere	ʻereʻere 
blood: toto | matee	toto 
blow: puhipuhi | farara	hiamòorre	puhi	puhuhi 
bone: ivi | ivi	opareemo 
breast: tītī | eom	eoo	ouma	tiitii	uu	ʻoouma	ʻōuma 
breathe: aho | huti i te aho	oròmàtoo 
burn: tānina i te auahi | tutuʻi | ana	ʻama 
child: tamariʔi | tamariʻi 
cloud: ata | ao	ata	eat 
cold: toʔetoʔe | mareere	maʻariri	to7eto7e	toʻetoʻe 
come: haere mai | eheèroharreehòe	haere mai	haeremai 
correct: ʔāfaro | tiʻa 
count: taiʔo | nūmera	taiʻo	tatau 
cut: tāpū | taapuu	tarai	tāpū 
die: pohe | mate	màtteno	màtteroah	pohe	wharrawai 
dig: heru | heru	pao	tūpā	ʻeru	ʻō 
dirty: repo | repo	repoa 
dog: ʔurī | uri	ʻurii	ʻūrī 
drink: inu | inu	norothoedéadeetʻavai 
dry: marō | maro	maroo	marroowhai	marō 
dull: mania | taimaha	teiaha	teimaha	toiaha | mania	toòmmoo	tuumuu	tūmū 
dust: huʔahuʔa | huʻahuaa	one	repo	repo puehu 
ear: tariʔa | tareeh	tari7a	tariʻa 
earth: fenua 
empty: pau 
eye: mata | mata	matau	muta 
fall: tex | itop	topa 
far: ātea | aatea	roa	ātea 
father: [pāpā] | metua taane	metua tane	mituatane	paapaa 
fat (n.): miʔi 
fear: riʔariʔa | mataʻu	riʻariʻa 
few: emea iti | maʻa 
fingernail: maiʔuʔu | maiʻuʻu 
fire: auahi | ahi	auahi	wahaeahei 
fish: iʔa | eiya	i7a	iʻa 
five: pae | illemei	pae	rima 
float: pāinu 
flower: tiare | pua	taire	tiare 
flow: tahe 
fly (v.): rere 
fog: rūpehu | ruupehu	rūpehu 
foot: ʔāvae | ʻāvae 
forest: ʔururāʔau | aru	ururaaʻau	ʻaihere 
four: maha | ha	haa	maha 
frog: [rana] 
fruit: māʔa hotu | hoora-ooiro	huero	maaʻa	māʻa 
full: ʔī | api 
give: hōroʔa | horo7a	hōroʻa 
good: maitaʔi | maitaʻi	maite7i	manamanatey	myty 
grass: mātie | matie	ʻaihere 
green: mātie | matie	niinamu	poemeedee 
guts: ʔāʔau | ʻaaʻau	ʻāʻau 
hair: rouru | eraowroo	rouru 
hand: rima 
head: upoʔo | erowroo	upoio	upoʻo 
hear: faʔaroʔo | aiwee	fa7aro7o	faʻaroʻo	ra7aro7o 
heart: māfatu | mafatu	māfatu 
heavy: teiaha | taimaha	teiaha	teimaha	toiaha 
he: ʔoia | ʻoia	ʻōna 
hit: tūpaʔi | taaʻiri	taparahi 
horn: tara 
how: nāfea | naafea	nāhea 
husband: tāne | taane	tan faʻaipoipo	tane 
ice: pape paʔari | pape toʻetoʻe 
if: mai te mea ē | ʻia	ʻāhiri 
in: i roto | i	i roto	roto 
I: vau | au	naow	vau	v|au	waow 
kill: haʔapohe | haʻapohe	taparahi	tapataparahi-pohe-roa	tararahi 
knee: turi 
know: ʔite | ite	ʻite	ʻito 
lake: roto 
large: rahi | nui	rahi 
laugh: ʔata | ʻata 
leaf: rauʔere | ewawaowerao	rao7ere	raoʻere	rau	rau7ere	rauʻere 
left: ʔaui | aruri	ʻaio	ʻaui 
leg: ʔāvae | ʻāvae 
lie: ta?oto | moe	ta7oto	taʻoto | tārava 
live: ora 
liver: upaʔa | upa7a	ʻupaʻa	ʻūpaʻa 
long: roa | oëoëteres	roa 
louse: ʔutu | oatoo	utu	ʻutu 
man: tāne | ta7ata	tata	taʻata 
many: e rare rahi 
meat: ʔiʔo | eeree	inaʻi	ʻiʻo 
moon: ʔāvaʔe | ava7e	maram	marama	ʻaavaʻe 
mother: [māmā] | maamaa	metua vahine	mituaheine 
mountain: mouʔa | mou7a	mouʻa 
mouth: vaha | ewauh	vaha 
name: iʔoa | i7oa	iʻoa 
narrow: oaoa | [ʻaa]oaoa	oaoa	piripiri 
near: fātata | faatata	fatata	whattata 
neck: ʔaʔ | e7i	eaee	ʻaʻii	ʻaʻī 
new: ʔāpĩ | api	hoou	ʻaapii	ʻāpī 
night: Pō | po	poo	ru7i	ruʻi 
nose: ihu | eahoo	ihu 
old: rūʔau | tahitro 
one: hōʔē | ho7e	hooʻee	hōʻē	tahi	tohe 
person: taʔata | ta7ata	tata	taʻata 
play: haʔuti | haʻuti 
pull: huti | ʻume 
push: tūraʔi | turaʻi 
rain: ʔua | eworooai	ua 
red: ʔuteʔute | ute7ute	ʻura	ʻuteʻute 
right: ʔatau | rima | ʻatau 
river: ʔānāvai | tahora	ʻānāvai 
road: [purūmu] | ara	ea7ia	eatia	eaʻtia	poromu	poroomu	purumu	puruumu	ʻeeʻa 
root: aʔa | a7a	aʻa 
rope: taura | taod	taura 
rotten: pē | pee	pē	ʻoopee 
round: menemene 
rub: ʔui | ʻuiʻui 
salt: miti popaʔā | miri	miti	taitai 
sand: one 
say: faʔaʔite | paraowmai	parau	porai	ʻī | one 
sea: miti | miti	moana	tai 
seed: huero 
sew: [nira] | au	nira	tui 
sharp: ʔoi | oi	ʻina	ʻoeʻoe	ʻoi 
short: poto | [po]poto	poto 
sing: hīmene | hīmene	pehe 
sit: pārahi | noho	paarahi	parahei	parahi	pārahi 
skin: ʔiri | eweyoraèe	iri	ʻiri 
sky: raʔi | raʻi 
sleep: taʔoto | iraòwai	moe	ta7oto	taoto	taʻoto 
small: iti | iti	na7ina7i	naʻinaʻi	riʻi 
smell: hauʔa | ephàow	hauʻa	hoʻi 
smoke: auauahi | auauahi	au|ahi	eohoo 
smooth: mānina 
snake: [ʔōfĭ] | ʻoofii	ʻōfī 
snow: [hiona] 
some: tetahi | nau	tau 
spit: tutuha | [tu]tuha	hooàre	tootoòà	tuha	tutuha 
split: ʔāmaha | tuha	vaahi	vāhi 
stab: pātia | paatia	paatia[tia]	pātia 
stand: ti?a | ti7a | eetoò	one	tiʻa	tuu	ʻotiʻatiʻa 
star: fētiʔa | efedee	feti7a	fetiʻa	fetuu 
stick: tura toʔotoʔo | mauhaʻa	ʻaamaʻa 
straight: ʔāfaro | tiʻa	ʻāfaro 
suck: ʔote | eotte	miti	ʻote 
sun: mahana | mahana	mahāna 
tail: ʔaero | eairo	ehaòwpè	hi7u	hiʻu	hope	itere	ʻaero	ʻitere 
they: rātou | raatou	raaua	rātou 
thick: meʔumeʔu | meʻumeʻu	mènne	tuetue 
think: feruri | manaʻo 
thin: rairai 
thou: ʔoe | outou	tooanahoe & tooanahahow	ʻoe 
thou: ʔoutou | outou	tooanahoe & tooanahahow	ʻoe 
three: toru | torhoo	toru 
throw: taora | hamu	taaora	tāora 
tie: tāʔamu | nati	ruru	ruruʻu	taʻai	taʻamu 
tongue: arero | arero	treero 
tooth: niho | eneeho	niho 
tree: tumu rāʔau | ra7au	rāʻau 
turn: huri | tīoi 
two: piti | piti	rooa	rua 
vomit: pihaʔe | pihaʻe	ruaʻi 
warm: veʔaveʔa | maahanahana	mahanahana	māhanahana	verrverra 
wet: haumi | rari 
what: eaha | aha	e aha	eaha 
when: ʔāfea | aafea	ahea	ehai	inaafea	naahea	nehàia 
which: teihea 
white: ʔuoʔuo | [tea]tea	teà	uo7uo	ʻuoʻuo 
who: ʔo vai | ovai	vai	v|ai	ʻo v|ai 
why: no te aha 
wide: ʔaʔano | ʻaʻano	ʻāʻano 
wife: vahine | huaheine	maheineeawaow	vahine	vahine faʻaipoipo 
wind: mataʔi | matai	mataʻi 
wing: pererau 
woman: vahine | aheine	vahine 
worm: toʔe | toʻe	tuʻa 
wrong: hape 
year: matahiti 
yellow: reʔareʔa | poeooleoole	re7are7a	reʻareʻa 
every: anaʻe	atoʻa	ta7ato7a 
ash: eàrahow	rehu	rehu auahi 
abdomen: eoboo	opu	ʻoopuu	ʻōpū 
big: nui	rahi 
bigness: nui	rahi 
breasts: eom	eoo	ouma	tiitii	uu	ʻoouma	ʻōuma 
burn tr.: tutuʻi 
come from: eheèroharreehòe	haere mai	haeremai 
be dead: mate	màtteno	màtteroah	pohe	wharrawai 
dead: mate	màtteno	màtteroah	pohe	wharrawai 
ground: fenua 
land: fenua 
soil: fenua 
eat: amu	eei	ʻai	ʻamu 
egg: hooirmoa	hooro	huero 
feather: hetehete	hurhuru	huruhuru 
fly: airareè	mauʻe	rere 
fly v.: airareè	mauʻe	rere 
left hand: rima 
1 sg.: au	naow	vau	v|au	waow 
be knowledgeable: ite	ʻite	ʻito 
lie down: moe	ta7oto	taʻoto 
head louse: oatoo	utu	ʻutu 
male: taane	tane	ta|ane	tāne 
many: rahi 
much: rahi 
multiple: rahi 
several: rahi 
hill: mou7a	mouʻa 
title: i7oa	iʻoa 
nighttime: po	poo	ru7i	ruʻi 
not: aita	ʻeaia 
adulterous: ho7e	hooʻee	hōʻē	tahi	tohe 
single: ho7e	hooʻee	hōʻē	tahi	tohe 
that: ra	teeraa	tee|naa	terrā 
the: ho7e	hooʻee	hōʻē	tahi	tohe 
unprincipled: ho7e	hooʻee	hōʻē	tahi	tohe 
human: ta7ata	tata	taʻata 
human being: ta7ata	tata	taʻata 
rainy weather: eworooai	ua 
path: ara	ea7ia	eatia	eaʻtia	poromu	poroomu	purumu	puruumu	ʻeeʻa 
route: ara	ea7ia	eatia	eaʻtia	poromu	poroomu	purumu	puruumu	ʻeeʻa 
see: hi7o	hiʻo	ite	ʻite 
hide: eweyoraèe	iri	ʻiri 
little: iti	na7ina7i	naʻinaʻi	riʻi 
smallness: iti	na7ina7i	naʻinaʻi	riʻi 
rock: ofa7i	owhai	ʻoofaʻi	ʻōfaʻi 
stone: ofa7i	owhai	ʻoofaʻi	ʻōfaʻi 
swim: au	eaow	ʻau 
this: teie	tʻèna 
2 sg: outou	tooanahoe & tooanahahow	ʻoe 
you: outou	tooanahoe & tooanahahow	ʻoe 
grind: piti	rooa	rua 
go: haera	haere	ori 
walk: haera	haere	ori 
hot: maahanahana	mahanahana	māhanahana	verrverra 
water: avy	pape	vai 
1 pl. inc.: maatou	maaua	matou	mātou	taatou	taaua	tatou	tātou 
we: maatou	maaua	matou	mātou	taatou	taaua	tatou	tātou 
we₁: maatou	maaua	matou	mātou	taatou	taaua	tatou	tātou 
whiteness: [tea]tea	teà	uo7uo	ʻuoʻuo 
who?: ovai	vai	v|ai	ʻo v|ai 
female: aheine	vahine 
distant: aatea	roa	ātea 
serious: taimaha	teiaha	teimaha	toiaha 
close: faatata	fatata	whattata 
ner: faatata	fatata	whattata 
earthworm: toʻe	tuʻa 
3 sg.: ʻoia	ʻōna 
she: ʻoia	ʻōna 
2 pl.: ʻoorua	ʻoutou 
ye: ʻoorua	ʻoutou 
you all: ʻoorua	ʻoutou 
3 pl.: raatou	raaua	rātou 
here: iho nei 
there: iho na 
where: harehie	hea	nooie tehai	tehai	tei hea 
where?: harehie	hea	nooie tehai	tehai	tei hea 
when?: aafea	ahea	ehai	inaafea	naahea	nehàia 
how?: naafea	nāhea 
other: vetahi[ʻee]	ʻē 
broad: ʻaʻano	ʻāʻano 
wideness: ʻaʻano	ʻāʻano 
fat: hinu	maʻi	miʻi	paiy 
principal wife: huaheine	maheineeawaow	vahine	vahine faʻaipoipo 
his mother: maamaa	metua vahine	mituaheine 
my mother: maamaa	metua vahine	mituaheine 
his father: metua taane	metua tane	mituatane	paapaa 
my father: metua taane	metua tane	mituatane	paapaa 
woods: aru	ururaaʻau	ʻaihere 
branch: mauhaʻa	ʻaamaʻa 
cord: taod	taura 
flesh: eeree	inaʻi	ʻiʻo 
grease: hinu	maʻi	miʻi	paiy 
claw: maiʻuʻu 
nail: maiʻuʻu 
arm: rima 
gut: ʻaaʻau	ʻāʻau 
insides: ʻaaʻau	ʻāʻau 
intestine: ʻaaʻau	ʻāʻau 
intestines: ʻaaʻau	ʻāʻau 
breath: huti i te aho	oròmàtoo 
laughter: ʻata 
cogitate: manaʻo 
reflect: manaʻo 
sniff: ephàow	hauʻa	hoʻi 
afraid: mataʻu	riʻariʻa 
be afraid: mataʻu	riʻariʻa 
fright: mataʻu	riʻariʻa 
alive: ora 
be alive: ora 
life: ora 
living: ora 
fight: taputō 
hunt: aʻuaʻu	aʻuaʻu puaʻa 
beat: taaʻiri	taparahi 
strike: taaʻiri	taparahi 
hack: taapuu	tarai	tāpū 
cut open: tuha	vaahi	vāhi 
pierce: paatia	paatia[tia]	pātia 
scratch: mayneeneeormyneere	pāraʻu	raʻuraʻu 
tell lies: tārava 
turn around: tīoi 
turn round: tīoi 
drop: itop	topa 
grasp: mau	rave	taapeʻa 
hold: mau	rave	taapeʻa 
hold in arm: mau	rave	taapeʻa 
squeeze: eninnei	neneʻi	tāmau	ʻuʻumu 
wring: eninnei	neneʻi	tāmau	ʻuʻumu 
wipe: horoi 
wash: horoy 
wash clothes: horoy 
shove: turaʻi 
bind: nati	ruru	ruruʻu	taʻai	taʻamu 
fasten: nati	ruru	ruruʻu	taʻai	taʻamu 
tie up: nati	ruru	ruruʻu	taʻai	taʻamu 
enumerate: nūmera	taiʻo	tatau 
number: nūmera	taiʻo	tatau 
tally: nūmera	taiʻo	tatau 
have fun: haʻuti 
freeze: faatoʻtoʻe roa 
swell: ʻoru 
brook: tahora	ʻānāvai 
stream: tahora	ʻānāvai 
ocean: miti	moana	tai 
snow: hiona 
blaze: ana	ʻama 
day: mahana 
daylight: mahana 
daytime: mahana 
evil: ʻino 
rot: pee	pē	ʻoopee 
filthy: repo	repoa 
soiled: repo	repoa 
blunt: mania	toòmmoo	tuumuu	tūmū 
damp: rari 
right side: ʻatau 
inside: i	i roto	roto 
with: ma 
