all: mamimin | malóvot	maləvə́t 
and: kano | kani	kanuʔ 
animal: omomalalam 
ashes: avo | avo	ʔávuʔ 
back: likoḍ | likod	likud	piṣagatán 
bad: mazaət | mala:ɤə́t	maráhet 
bark: kolit no kayo 
because: ta 
belly: vitoka | velek	vələ́k 
bird: miasasalap | laciw	miaṣaṣaláp 
bite: soŋit | songit	ŋətŋətə́n 
black: mavaəŋ | maváheng	maβaɤən	maṣáriʔ 
blood: ẓala | rala	rala7	ralaʔ 
blow: aviotan | avyot	opag	ʔaviután 
bone: totowaŋ | totoaN	totoang	tuaN	tuɤan	tuʼáŋ 
breast: ṣoṣo | soso	susu7	ṣuṣuʔ 
breathe: mininawa | umininawáʔ 
burn: aṣləbən | kozad	manutún	miṣələṣələ́b 
child: kanakan 
cloud: činalab | cinalab 
cold: maẓəkmə | marékmeh	marəkmə́ʼ 
come: mai | jijanaʔ	mai	yiyana7 
correct: manoyoŋ 
count: mivilaŋ | vilangan	vilaŋán 
cut: aktəbən | aripen	cibcibə́n 
die: marakat | maliman	marakat	marakát 
dig: mikali | kaliin	mikalíʔ 
dirty: malolit | malóit	malúʼit 
dog: [ino] | %ino	%inu7	agsa	ino	ʔinuʔ 
drink: inom | inomen	minum	miyup 
dry: makor̃ay | kozayin	makjít	makozay 
dull: maŋalə | maréhmet	marə:mət | mangáreh	maŋáləʔ 
dust: liŋbo | ibek	ṣalivuváu 
ear: taliŋa | taliN7	taliNa	talinga	talíŋaʔ	taregan 
earth: tana 
egg: ičoy | icioy	iĉai	ʔicəɪʼ 
empty: abo o oẓan na 
eye: mata | mata	mata7	mátaʔ 
fall: makaṣ | makás	matúluʔ	mazba 
far: maẓai | mará:iʼ	marái 
father: ama | ama	ʔamaʔ 
fat (n.): tava 
fear: manyaəy | mamogaw	maniaɤiʔ	maniaɤəíʔ 
few: yapəẓə 
fingernail: koko 
fire: apoy | apoy	riyar	ápui 
fish: amoŋ | amoN	among	ʔamə́ŋ 
five: lima 
float: maʁataʁataw 
flow: amvoyog | iríd	ʼiríəd 
flower: ṣavoŋ | hanaʔ	savosavong 
fly (v.): ṣomalap 
fog: kanaəpkəp | cinalab 
foot: ai 
forest: kaisʁaṣan | kakayoan 
four: apat | ap-pat	apat	ápat 
frog: toratora 
fruit: aṣi no kayo | asiasi no kayo	ʔaṣi 
full: mapno 
give: ipanta 
good: yapia | apía	yapíʼaʔ	ʔapíʼaʔ 
grass: tamək 
green: mogaẓo | mowgáraw	mugárau 
guts: činayi | cinai	cinaʼíʔ 
hair: avok | ovok	uvək 
hand: lima | lima	límaʔ	rukap	tanoḷo 
head: oʁo | oo	uʼuʔ	voboya 
hear: mamir̃əŋ | aTiTilwan3n	amiziNen	amizingen	mamiliN	mamiliŋ	ʔacicil wanə́n 
heart: tawor 
heavy: maṣagpo | maréhmet	marə:mət 
he: iya 
hit: bakbakan | mililiman	palu 
horn: oroŋ 
how: ikoŋo | inmaguŋ	ápira 
husband: maʁakay na | mehakay 
ice: kori 
if: ṣi | no 
in: ḍo saʁaḍ | rəṣaʼadnáʔ 
I: yakən | aku	yak3n	yakə́n 
kill: rakatэn | limanen	rakatə́n	zakaten 
knee: atoḍ 
know: katənŋan | katəŋán	kátenngan 
lake: mibəbnəŋ a ẓanom | mibebneng a ranom	ʔattáu 
large: azako | [ya]rákuʔ	aráko 
laugh: mikamiŋ | mamín	mamíən	mámiying 
leaf: voʁoŋ | vohoN	vohong	vuuN	vuʼúŋ 
left: ori | kaʼuriʔ	ozi 
leg: ai 
lie: miẓay | mangalalas	mirái 
live: maviay | maviʼái 
liver: atay | ap3du7	atay	ʔapədúʔ 
long: anaẓo | anáro	yanáruʔ 
louse: koto | koto	kutu7	kútuʔ 
man: maʁakay | tao	tau 
many: aẓo 
meat: aṣiṣi | ʔasisíʔ 
moon: vəan | vehan	vuʼán 
mother: ina | ina	ínaʔ 
mountain: tokon 
mouth: ŋoṣo | ngongoy	ŋuṣuʔ 
name: ŋazan | Naran	ngaran	ŋarán 
narrow: məylid | líkiʼ	méylid 
near: maṣŋən | maṣəŋə́n	másngen 
neck: ragaw | ragau	zagaw 
new: avayo | vayo	vayu7	váyuʔ 
night: aəp | ma83p	ma:ɤəp	mahep 
nose: momoḍan | momodan	momosa	mumudan	mumudán 
old: aḍan 
one: aṣa | asa	asa7	ása	ʔáṣaʔ 
person: tao | tao	tau 
play: mialalam 
pull: miŋitən 
push: padondonən 
rain: čimoy | cimoy	címui 
red: mabaẓaŋbaŋ | mabazángbang	miválah 
right: wanan | lima	límaʔ	rukap	tanoḷo | kawanán	wanan 
river: ayo 
road: ẓaẓaĸan | laxan	raraan	rarahan	raraʼán	ḷaɤan 
root: yamot | yamot	yamut	ʔatəŋə́ʔ 
rope: kolili | karái	ovid 
rotten: mavoŋtot | manái	mayugyug	mehta 
round: maəḍəḍ 
rub: ponaṣan 
salt: aṣin | asin	ɤana	ʔasín 
sand: anay | anay	kararakád	ʔanai 
say: ipanči | vataen	ʔipanjíʔ | anay	kararakád	ʔanai 
sea: awa | attaw	awa	ʔatáu 
seed: vəttow 
sew: manapaŋ | ma-ḷait	pananapaŋan	tapangen 
sharp: mataẓəm | matárem	matárəm 
short: maəpẓəp | alígned	mavéveh	yalíŋəd 
sing: mianoanoʁoḍ 
sit: omlisna | lísna	tumlatuḍ	ʔəmliṣnáʔ 
skin: kolit | kolit	kulit	kulít 
sky: aŋit | angit	áŋit	ɤaŋit 
sleep: mitkə | mitkeh	mitʔkəʼ 
small: alikəy | [y]alíkiʼ	aLíkey	ʔalíkəiʼ 
smell: aŋnoən | angno	ṣirəŋətə́n 
smoke: aob | ahob	ʔaʼub 
smooth: mowaṣ 
snake: voləy | volay	vulái 
snow: kori 
some: kaẓoanna 
spit: čipa | cipa	cípaʔ	čippa 
split: piṣiẓaən | məṣalad	riček 
stab: pasobsobən | iɤu	patuvurə́n	vónoen 
stand: tomanək | tumanə́k	tánek 
star: mata no aŋit | mata no angit	mata nu ʼaŋít	matanoaNit	matanuaNit 
stick: ṣiṣikod | mehta 
suck: čiropən | cizopen	sepsepen	ʔijútan 
sun: aẓaw 
tail: ipoṣ | ipos	ipús 
they: ṣiẓa | sila	sira	siraituʔ 
thick: magṣar̃ | magṣár	mágsaz 
think: v-ən-aruŋ | naknakmə́n 
thin: mataẓipiṣ | matarípis 
thou: imo | imu7	ʔimuʔ 
thou: kamo | imu7	ʔimuʔ 
three: atlo | atlo	atoro	teylo	tiluʔ 
throw: patəlmən | patelemen	pavuyug	picilauṣə́n 
tie: bəḍbəḍən | ikut	pitanəŋə́n 
tongue: lila | lila	lila7	lílaʔ 
tooth: ŋəpən | N3p3n	Nepen	ngepen	ŋəpə́n 
tree: kayo | kayu7 
turn: valyatən 
two: aḍwa | adoa	dowa	roa	rua7	ruʼaʔ 
vomit: ota | motowta	muto:táʔ 
warm: makwat | yapíʼaʔ kakawan 
wet: mavasa | mavasa	mavaṣaʔ 
we: yamən | yamen	yamə́n	yat3n	yatə́n 
what: ikoŋo | ikong	yukúŋ 
when: ṣi maŋo | anukaŋuʔ	mango	simaŋuʔ 
which: waǰin ḍaŋ 
white: malavaŋ | malávang	malávaŋ 
who: ṣino | sinuʔ	síno 
why: ikoŋo 
wide: movoŋ | magṣár	mówvong 
wife: mavakəṣ na | mavakes 
wind: pagpag | aŋin	pagpag	sazowsaw 
wing: panid | panid	pañíd 
woman: mavakəṣ | mavakes	mavakə́ṣ	vavakə́ṣ 
worm: kalkaltən | kalkalten	uʼəd 
wrong: malaṣ 
year: kawan 
yellow: koaẓəy | akumi pugapuga	máray 
every: malóvot	maləvə́t 
ash: avo	ʔávuʔ 
abdomen: velek	vələ́k 
big: [ya]rákuʔ	aráko 
bigness: [ya]rákuʔ	aráko 
breasts: soso	susu7	ṣuṣuʔ 
burn tr.: kozad	manutún	miṣələṣələ́b 
come from: jijanaʔ	mai	yiyana7 
be dead: maliman	marakat	marakát 
dead: maliman	marakat	marakát 
eat: koman	kumán 
feather: bobow	bubúʼ	pañid 
fly: somalap	ṣəmalap 
fly v.: somalap	ṣəmalap 
left hand: lima	límaʔ	rukap	tanoḷo 
1 sg.: aku	yak3n	yakə́n 
be knowledgeable: katəŋán	kátenngan 
lie down: mangalalas	mirái 
head louse: koto	kutu7	kútuʔ 
male: mehakay	məʼakái	shichi 
title: Naran	ngaran	ŋarán 
nighttime: ma83p	ma:ɤəp	mahep 
adulterous: asa	asa7	ása	ʔáṣaʔ 
single: asa	asa7	ása	ʔáṣaʔ 
that: ʔuʼituʔ 
the: asa	asa7	ása	ʔáṣaʔ 
unprincipled: asa	asa7	ása	ʔáṣaʔ 
human: tao	tau 
human being: tao	tau 
rainy weather: cimoy	címui 
path: laxan	raraan	rarahan	raraʼán	ḷaɤan 
route: laxan	raraan	rarahan	raraʼán	ḷaɤan 
see: Tita7	Titaen	citaen	cítaʔ	kita7	kítaʔ 
hide: kolit	kulit	kulít 
little: [y]alíkiʼ	aLíkey	ʔalíkəiʼ 
smallness: [y]alíkiʼ	aLíkey	ʔalíkəiʼ 
rock: vato	vatu7	vátuʔ 
stone: vato	vatu7	vátuʔ 
swim: miawawat	milwawát 
this: oya	ʔúyaʔ 
2 sg: imu7	ʔimuʔ 
you: imu7	ʔimuʔ 
grind: adoa	dowa	roa	rua7	ruʼaʔ 
go: omalam	umalam 
walk: omalam	umalam 
hot: yapíʼaʔ kakawan 
water: ranom	ranúm 
1 pl. inc.: yamen	yamə́n	yat3n	yatə́n 
we₁: yamen	yamə́n	yat3n	yatə́n 
whiteness: malávang	malávaŋ 
who?: sinuʔ	síno 
female: mavakes	mavakə́ṣ	vavakə́ṣ 
distant: mará:iʼ	marái 
serious: maréhmet	marə:mət 
close: maṣəŋə́n	másngen 
ner: maṣəŋə́n	másngen 
earthworm: kalkalten	uʼəd 
year: awan 
2 pl.: imo	íñuʔ 
ye: imo	íñuʔ 
you all: imo	íñuʔ 
3 pl.: sila	sira	siraituʔ 
where: jíno	ruajín 
where?: jíno	ruajín 
when?: anukaŋuʔ	mango	simaŋuʔ 
how?: inmaguŋ	ápira 
other: karuʼan 
broad: magṣár	mówvong 
wideness: magṣár	mówvong 
fat: tava	ʔánəŋ 
principal wife: mavakes 
his mother: ina	ínaʔ 
my mother: ina	ínaʔ 
his father: ama	ʔamaʔ 
my father: ama	ʔamaʔ 
woods: kakayoan 
branch: mehta 
cord: karái	ovid 
flesh: ʔasisíʔ 
grease: tava	ʔánəŋ 
gut: cinai	cinaʼíʔ 
insides: cinai	cinaʼíʔ 
intestine: cinai	cinaʼíʔ 
intestines: cinai	cinaʼíʔ 
breath: umininawáʔ 
laughter: mamín	mamíən	mámiying 
cogitate: naknakmə́n 
reflect: naknakmə́n 
sniff: angno	ṣirəŋətə́n 
afraid: mamogaw	maniaɤiʔ	maniaɤəíʔ 
be afraid: mamogaw	maniaɤiʔ	maniaɤəíʔ 
fright: mamogaw	maniaɤiʔ	maniaɤəíʔ 
alive: maviʼái 
be alive: maviʼái 
life: maviʼái 
living: maviʼái 
beat: mililiman	palu 
strike: mililiman	palu 
hack: aripen	cibcibə́n 
cut open: məṣalad	riček 
pierce: iɤu	patuvurə́n	vónoen 
scratch: kadkaden	kadkadə́n 
drop: makás	matúluʔ	mazba 
grasp: aɤap	pinanan	ʔapən 
hold: aɤap	pinanan	ʔapən 
hold in arm: aɤap	pinanan	ʔapən 
squeeze: zamosen	ʔakbəŋə́n 
wring: zamosen	ʔakbəŋə́n 
bind: ikut	pitanəŋə́n 
fasten: ikut	pitanəŋə́n 
tie up: ikut	pitanəŋə́n 
enumerate: vilangan	vilaŋán 
number: vilangan	vilaŋán 
tally: vilangan	vilaŋán 
ocean: attaw	awa	ʔatáu 
evil: mala:ɤə́t	maráhet 
rot: manái	mayugyug	mehta 
filthy: malóit	malúʼit 
soiled: malóit	malúʼit 
blunt: mangáreh	maŋáləʔ 
damp: mavasa	mavaṣaʔ 
right side: kawanán	wanan 
at: do 
inside: rəṣaʼadnáʔ 
