all: kap | káp 
at: a mbə 
belly: mbu 
big: gwandə | gori 
bird: kuzha | ɗíkì 
black: tit | tiɗ 
blood: tom | tom	tòm 
bone: ɠəɬ | g3L	ɠəɬ 
come: ɓa | ba	ɓa 
die: məɗə | m38i	məɗi 
dog: yiɗa | yi8a	yiɗa 
drink: za 
ear: ɮəm | L3m	ɮim 
earth: ɣay 
eat: nji | nǯi	zəmi 
egg: ŋgarɮi | ŋgarɮì 
eye: yitə | yiti 
fire: ɓay | bay	ɓay 
fish: yurvu | yurvu	yurvù 
five: ɠurmun 
foot: sara | pəli sarà 
four: vat 
give: vərə | vəri 
hand: xar | bə́n	xar 
head: ʔjin | ɟin 
hear: təkə | t3ki	tekì 
he: tin 
I: ŋa | Na	ŋa 
knee: purum | purum	xuLukti	xuluktì 
know: zənə | maɣa 
long: kər | kə́rì 
man: xusku | ndúkù 
many: xaŋ | xáŋ 
moon: tera 
mouth: me 
name: ɮəm | L3m	ɮim 
night: viɗki | vi8ki	viɗki 
nose: xən | x3n	xə̀n 
not: ɓá 
one: da 
red: vyaŋ | vyàŋ 
road: ndəva | nd~3va 
rope: zo 
say: za | žì 
see: na 
skin: kəzəm | k3z3m	kəzəm 
sleep: ɗeni | čí ɗéni 
snake: səɗə | sə́ɗí 
stand: tiŋə 
stone: ndogu | nd~ogu	ndògu 
sun: fəɗa | f38a	fəɗà 
that: na-nda | nánda 
they: war 
this: na | ná 
thou: to | to	tó 
three: kunu 
tongue: ɣena | xena	ɣenà 
tooth: ɮin | Lin	ɮìn 
tree: ɠəfa | g3fa 
two: rap 
water: ʔjim | Tim	ɟim 
we: tem | tem	temi 
what: nəma | nə́ma 
when: koti 
where: fən 
white: ɓoŋ | boŋ 
who: ki | kiyá 
woman: nushu | nušu 
you: tun | to	tó 
every: káp 
ash: pəǯit 
ashes: pəǯit 
bark: gə̀ɓà 
abdomen: mbu 
bigness: gori 
large: gori 
bite: kə́ɗi 
breast: ɓùɓu 
breasts: ɓùɓu 
claw: xə̀nndəxar 
nail: xə̀nndəxar 
talon: xə̀nndəxar 
cloud: kòzòp 
cold: ndoldnol 
come from: ba	ɓa 
be dead: m38i	məɗi 
dead: m38i	məɗi 
dry: ɣwari 
feather: ɣos 
fly: gəri 
fly v.: gəri 
full: nǯeɮì	ɲeɮì 
good: mbari 
green: líwnà líwnà 
hair: ɣox 
left hand: bə́n	xar 
right: bə́n	xar 
heart: čučómbòl 
horn: doma 
1 sg.: Na	ŋa 
kill: ɬagà 
be knowledgeable: maɣa 
leaf: lòɣòs	ɮimndə gəfa 
liver: ɗúɗóm 
male: xuskù 
much: xáŋ 
multiple: xáŋ 
several: xáŋ 
hill: ɮèŋ 
mountain: ɮèŋ 
title: L3m	ɮim 
neck: ɠura 
new: mewa 
nighttime: vi8ki	viɗki 
not: ɓa 
adulterous: da 
single: da 
the: da 
unprincipled: da 
human: ndúkù 
human being: ndúkù 
person: ndúkù 
rain: roma 
rainy weather: roma 
path: nd~3va 
route: nd~3va 
root: ɮə̀ɮà 
round: sàkukúr 
sand: wuɟi 
seed: pòn 
sit: xá 
hide: k3z3m	kəzəm 
little: kóɗómmá 
small: kóɗómmá 
smallness: kóɗómmá 
smoke: gən 
star: anǯinǯà 
rock: nd~ogu	ndògu 
swim: gə ɟim 
tail: ganà 
2 sg: to	tó 
grind: rap 
go: yí 
walk: yí 
1 pl. inc.: tem	temi 
we₁: tem	temi 
whiteness: boŋ 
who?: kiyá 
female: nušu 
yellow: likám líkam 
distant: giɗi 
far: giɗi 
dull: taɗà 
heavy: taɗà 
serious: taɗà 
close: biŋ 
near: biŋ 
ner: biŋ 
salt: ɮèrù 
short: kútúxúm 
thin: líŋlíŋ 
wind: xəxet 
earthworm: xògà 
worm: xògà 
year: soní 
