all: ɨnk\ɨk | ɨnkʼɨk 
ashes: tsɨbɨr 
bark: suː\ka | suːʼka 
belly: giːzu | gizuː	giːzu 
big: zəːjɔ 
bird: ziːla | zilaː	ziːla 
bite: ts\aːyu | tsʼaːyu 
black: nič\ir | ničʼir 
blood: bɨr | b3r	beraː	bɨr 
bone: atsɨn | Nas"	ac3n	atsɨn 
breast: ɨːqʷ | 3qw~	eròkʔu	ɨːqʷ 
burn: q\atlɨlzu 
claw: qač\ɨl | qačʼɨl 
cloud: dɨmʲa | dɨmⁱna 
cold: kiːbɛ | keb	kiːbɛ 
come: tɛːru | tEr	tEru	tɛːru 
die: qɨruː | k3r	ku-r	q3ru	qɨruː 
dog: qɨzɨŋ | g3z3N	gezeŋ	qɨzɨŋ 
drink: ziːyu | zikʔ	ziy	ziyu	ziːyu 
dry: jiːzoʷ 
ear: qərɨz | q3r3z	qEr3z	qərɨz 
eat: xoː | hu	xoː 
egg: qulʊːna 
eye: ɨl | 3l	ɨl	ʕäl 
father: yiːr 
fat (n.): sɔ\wɔʷ 
fly (n.): ts\ɨts\a 
foot: lukʷ | lukʷ	lúku 
give: yuː 
good: k\əsəʷ | kʼəsəʷ 
grass: ts\aːka 
hair: tsɨvk\a | tsɨvkʼa 
hand: nɛn | nEn	nan	naːn	nɛn 
head: aːwɨr | awúr	aːwɨr 
heart: ɨːzɛn 
hear: wɔːšuː | wES	woSu	wɔːšuː 
horn: ǯi | gyiː	ji	ǯi 
I: aːn | an	anaː	aːn	yan 
kill: qaːw | kʔaw	kʔuw	qaːw 
knee: gɨrɨb | g3r3b	g3rb	gɨrɨb 
know: aːrqʷ | arek	aːrqᵘ 
leaf: xaːts\a | Xas"a	xac"a	xaːtsʼa 
long: liːgzo | liges	liːgzo 
louse: bɨta | b3ta 
many: bič\ɨq | bičʼɨq 
man: ɨǯɨr | 3j3r	3j3ra	ägir 
meat: siːya | seyaː 
moon: arba | arba	arbaː 
mountain: aːba | aba	aːba 
mouth: mɨǯ(ǯ)ɛ | mɨǯǯɛ	mɨǯɛ 
name: šuːŋ | S3Nw~	SuN	šuːŋ 
neck: kɨlma 
new: aːyir | ay3r	ayir	aːyir 
night: haːr | har	haːr	xar 
one: ləːwa | l3wa	lEwa	lay	láwā	ləːwa 
other: laːq 
rain: sowa | sowa	suwaː 
red: səːroʷ | sär	səːroʷ 
road: gwiːdɛna | gw~idEna 
root: sɨr 
sand: a˗šɛwɛ | a-šɛwɛ 
say: yuː | y	yuː 
seed: ziːra 
see: qaluː | kʔaːl	qal	qalu	qaluː 
sit: qɔyuː 
skin: k\ɛrbɨr | k"Erb3r	kʼɛrbɨr	qEbri	qErbi 
sleep: xəriyuː 
small: ɨ\t\ɨn | ɨʼtʼɨn 
smoke: t\iːya | tʼiːya 
snake: siːvra 
stand: čibɨru 
star: tsɨgolowa | c"3golowa	s"3gl3wa	tsɨgolowa 
stone: qarʲa | kernaʼ	kerŋaː	q3rNa	qar3Na	qarNa	qarⁱŋa 
sun: kwaːra | kwaːra	kw~Era	kw~ara 
swim: bɛbuː 
tail: č\ɨra | čʼɨra 
thin: siːyu 
this: ɛneɛnene˗ ˗d | ɛneɛnene- -d 
thou: kɨt | k3t	kɨt 
three: šaːqʷa 
tongue: laːq | laq	laːq 
tooth: ɨruʠ | 3r3qw~	3ruq	erúkʔ	ɨruʠ 
tree: zɛf | zEf 
two: liːŋa | liNa	liŋa	liːŋa 
walk: fiːru 
warm: bɛːro 
water: aːqw | akʔu	akʔui	aqw~	aːqw 
wet: ɔːtɔn 
we: yiːn | y3n	yin 
what: wɔːrɛŋa 
white: tsaːroʷ | tsaːroʷ	tsʔar 
who: aw 
woman: uːʷna | ekʔuén	uːʷna 
you: kɨtɛn | k3t	kɨt 
every: ɨnkʼɨk 
ash: tsɨbɨr 
abdomen: gizuː	giːzu 
bigness: zəːjɔ 
large: zəːjɔ 
breasts: 3qw~	eròkʔu	ɨːqʷ 
nail: qačʼɨl 
talon: qačʼɨl 
come from: tEr	tEru	tɛːru 
be dead: k3r	ku-r	q3ru	qɨruː 
dead: k3r	ku-r	q3ru	qɨruː 
fire: liaː	liy	liyE	liya 
fish: Xaza 
full: Caqw~ 
green: lämlim 
left hand: nEn	nan	naːn	nɛn 
right: nEn	nan	naːn	nɛn 
1 sg.: an	anaː	aːn	yan 
be knowledgeable: arek	aːrqᵘ 
liver: S3q 
head louse: b3ta 
male: girwaː	ɨǯɨr 
much: bičʼɨq 
multiple: bičʼɨq 
several: bičʼɨq 
flesh: seyaː 
hill: aba	aːba 
title: S3Nw~	SuN	šuːŋ 
nighttime: har	haːr	xar 
nose: 3s3N	ɨsɨŋ 
adulterous: l3wa	lEwa	lay	láwā	ləːwa 
single: l3wa	lEwa	lay	láwā	ləːwa 
that: l3wa	lEwa	lay	láwā	ləːwa 
the: l3wa	lEwa	lay	láwā	ləːwa 
unprincipled: l3wa	lEwa	lay	láwā	ləːwa 
human: 3j3r	3j3ra	ägir 
human being: 3j3r	3j3ra	ägir 
person: 3j3r	3j3ra	ägir 
rainy weather: sowa	suwaː 
path: gw~idEna 
route: gw~idEna 
hide: k"Erb3r	kʼɛrbɨr	qEbri	qErbi 
little: ɨʼtʼɨn 
smallness: ɨʼtʼɨn 
rock: kernaʼ	kerŋaː	q3rNa	qar3Na	qarNa	qarⁱŋa 
2 sg: k3t	kɨt 
grind: liNa	liŋa	liːŋa 
hot: bɛːro 
1 pl. inc.: y3n	yin 
we₁: y3n	yin 
whiteness: tsaːroʷ	tsʔar 
who?: aw 
female: ekʔuén	uːʷna 
salt: čiwad 
year: amtaːn 
