ankle: miɹti 
back: ṭat̪i 
bad: wincan 
belly: maṭi 
big: kitliŋa 
bite: -titip- 
black: cikam 
blood: wulkiɹim 
bone: palkum 
breast: yeŋi 
cheek: ŋaɹmuɹit 
child: yipeṭi 
cloud: weŋi 
crocodile: akinipi 
cut: -kat- 
dig: -ṭuṭu- 
dog: wacan 
dust: penni 
ear: t̪aŋi 
earth: piɹek 
eat: -yimpuɹi- 
egg: amaɹi 
elbow: pipen 
emu: amuciɹ 
eye: mi 
father: yta 
fat (n.): aliyir 
feather: amuni 
fire: cenci 
five: punti ŋinɟi 
flower: maŋun 
foot: peɹi 
forehead: wemmi 
four: ɟiɟuk ɟiɟuk 
full: ciɹpinŋi 
good: kati 
grass: paɹi 
hair: maɹ̣ 
hand: wunti 
head: puŋitit 
heart: miɹiɹim 
heavy: wutit 
he/she: naŋ 
he/she: ŋa 
he/she: -ø- 
hole: yeɹi 
house: ŋatta 
I: -iŋ- 
I: yin 
kangaroo: awaɹtiwaŋ 
knee: peŋki 
laugh: -atu- 
leaf: maɹiɹ 
leg: waŋ 
liver: pacu 
long: malupu 
man: meme 
meat: yiliɹki 
moon: miɹeɹmin 
mosquito: aŋawak 
mother: kila 
mouth: ŋaɹ 
name: puma 
navel: ceɹtiɹ 
neck: mant̪i 
new: yaŋi 
night: nici 
not: ampu 
old: kunakuni 
old: mapintipinti 
old: muntak 
one: ŋinci 
rain: wuti 
red: kitinwiḷ 
red: kukaɹa 
ripe: weɲmiɹ 
river: peteɹ 
road: peɹi 
rope: puya 
rotten: kukup 
sand: menneɹ̣ 
sea: kicaɹ 
sharp: meltem 
shoulder: kaɹ̣i 
skin: ṭatipi 
small: yipeṭi 
smoke: waniɹik 
snake: apan 
spit: citeɹi 
spit: -kutluk- 
stand: -yaŋ- 
star: witli 
stone: kaɹalal 
straight: t̪atma 
sun: panti 
tail: yeɹi 
take: -mitim- 
they: -mpir- 
they: niwir 
they two: niwin 
they two: -wirti- 
thigh: puwa 
thou: -iɲ- 
thou: ner 
thou: niɲ 
thou: niwir 
thou: -ntir- 
three: animpir 
today: yeŋi 
tomorrow: niciŋani 
tongue: ŋininiŋ 
tooth: teɹ̣ 
tree: t̪awuɹ̣ 
two: cicuk 
vagina: piyiɹi 
vomit: wewəwe 
walk: -paɹup- 
wallaby: apeŋ 
wash: -ciput- 
water: wuti 
we (excl.): ɟar 
we (excl.): ɟer 
we (excl.): -ŋkir- 
we (incl.): kaŋkinim 
we (incl.): -ŋki- .... nim 
we two (excl.): karti 
we two (excl.): -ŋkiri- 
we two (incl.): kaŋki 
we two (incl.): -ŋki- 
what: yipe 
white: pukam 
who: ninimpe 
wind: maɹawuk 
woman: muku 
woomera: kalan 
year: waɹi 
yesterday: cuwya 
you two: narti 
you two: -ntiri- 
